MOIS;THEMATIQUES;TF1;France 2;France 3;Canal +;Arte;M6;Totaux
january-05;Catastrophes;214;191;88;18;40;49;600
january-05;Culture-loisirs;27;42;35;4;0;23;131
january-05;Economie;35;18;10;1;8;11;83
january-05;Education;14;12;4;3;3;8;44
january-05;Environnement;31;25;15;1;3;10;85
january-05;Faits divers;24;19;9;1;1;14;68
january-05;Histoire-hommages;36;38;24;10;23;19;150
january-05;International;52;61;54;15;108;26;316
january-05;Justice;20;27;16;11;11;7;92
january-05;Politique France;27;25;25;6;22;8;113
january-05;Santé;21;19;15;0;2;12;69
january-05;Sciences et techniques;28;11;11;4;2;7;63
january-05;Société;139;129;65;24;31;53;441
january-05;Sport;37;49;19;7;0;32;144
february-05;Catastrophes;42;30;13;4;14;14;117
february-05;Culture-loisirs;41;66;23;12;5;29;176
february-05;Economie;46;43;24;2;7;11;133
february-05;Education;27;31;22;7;7;10;104
february-05;Environnement;46;25;12;0;6;7;96
february-05;Faits divers;17;16;13;8;0;10;64
february-05;Histoire-hommages;14;12;12;1;9;4;52
february-05;International;100;110;81;26;160;32;509
february-05;Justice;56;52;43;15;8;26;200
february-05;Politique France;23;18;13;2;4;6;66
february-05;Santé;50;41;20;9;6;16;142
february-05;Sciences et techniques;17;15;10;0;4;4;50
february-05;Société;177;132;67;29;27;70;502
february-05;Sport;54;58;29;18;3;38;200
march-05;Catastrophes;47;44;27;1;10;20;149
march-05;Culture-loisirs;48;81;38;14;2;39;222
march-05;Economie;92;50;27;2;13;14;198
march-05;Education;33;24;15;3;4;18;97
march-05;Environnement;57;57;14;4;0;13;145
march-05;Faits divers;32;28;18;3;9;12;102
march-05;Histoire-hommages;7;7;1;1;3;0;19
march-05;International;109;140;104;30;189;47;619
march-05;Justice;44;60;30;13;21;14;182
march-05;Politique France;38;22;22;5;5;12;104
march-05;Santé;69;75;44;14;19;40;261
march-05;Sciences et techniques;29;27;8;3;3;6;76
march-05;Société;217;187;89;34;39;78;644
march-05;Sport;55;63;31;15;1;46;211
april-05;Catastrophes;16;17;7;1;2;7;50
april-05;Culture-loisirs;28;46;21;8;1;20;124
april-05;Economie;57;38;20;11;17;12;155
april-05;Education;12;13;7;2;2;7;43
april-05;Environnement;30;11;6;1;1;10;59
april-05;Faits divers;20;19;15;4;4;8;70
april-05;Histoire-hommages;34;34;19;6;13;14;120
april-05;International;74;82;66;16;130;23;391
april-05;Justice;33;26;35;19;5;18;136
april-05;Politique France;31;23;15;5;5;10;89
april-05;Santé;23;24;18;5;3;8;81
april-05;Sciences et techniques;13;12;8;1;5;6;45
april-05;Société;275;276;154;47;92;118;962
april-05;Sport;31;26;16;8;1;29;111
may-05;Catastrophes;12;11;7;1;0;8;39
may-05;Culture-loisirs;47;78;42;10;4;40;221
may-05;Economie;74;65;26;8;15;15;203
may-05;Education;24;9;7;1;4;6;51
may-05;Environnement;33;26;9;1;3;7;79
may-05;Faits divers;18;27;21;9;0;12;87
may-05;Histoire-hommages;22;31;17;4;17;13;104
may-05;International;154;216;119;42;220;66;817
may-05;Justice;43;41;26;19;12;17;158
may-05;Politique France;56;57;47;16;13;24;213
may-05;Santé;48;35;22;2;2;22;131
may-05;Sciences et techniques;31;23;6;0;2;7;69
may-05;Société;176;143;82;27;37;60;525
may-05;Sport;58;61;38;14;0;53;224
june-05;Catastrophes;37;24;20;1;8;12;102
june-05;Culture-loisirs;38;47;27;2;0;16;130
june-05;Economie;54;44;35;2;11;10;156
june-05;Education;19;22;12;3;2;13;71
june-05;Environnement;54;46;10;0;10;11;131
june-05;Faits divers;13;24;19;10;0;11;77
june-05;Histoire-hommages;3;10;6;0;3;3;25
june-05;International;95;105;91;14;168;26;499
june-05;Justice;51;44;31;11;12;20;169
june-05;Politique France;29;25;21;4;5;5;89
june-05;Santé;23;32;13;6;1;10;85
june-05;Sciences et techniques;22;25;3;1;3;4;58
june-05;Société;168;134;72;21;26;67;488
june-05;Sport;53;49;34;12;2;29;179
july-05;Catastrophes;43;46;15;9;12;13;138
july-05;Culture-loisirs;47;61;25;2;3;19;157
july-05;Economie;43;34;25;11;12;13;138
july-05;Education;9;11;8;2;1;3;34
july-05;Environnement;42;48;18;3;9;18;138
july-05;Faits divers;14;11;8;4;1;8;46
july-05;Histoire-hommages;8;11;9;1;4;4;37
july-05;International;185;208;134;52;148;72;799
july-05;Justice;22;23;23;14;17;12;111
july-05;Politique France;29;31;21;9;8;11;109
july-05;Santé;21;9;4;1;3;3;41
july-05;Sciences et techniques;16;24;7;9;9;8;73
july-05;Société;89;84;61;28;27;42;331
july-05;Sport;81;94;55;31;4;55;320
august-05;Catastrophes;142;169;96;35;48;58;548
august-05;Culture-loisirs;48;72;31;6;7;23;187
august-05;Economie;58;58;35;9;5;19;184
august-05;Education;25;19;12;3;2;15;76
august-05;Environnement;66;53;27;6;13;16;181
august-05;Faits divers;34;34;17;10;9;21;125
august-05;Histoire-hommages;14;15;17;2;12;11;71
august-05;International;67;81;53;38;176;33;448
august-05;Justice;15;20;19;4;7;4;69
august-05;Politique France;16;19;21;8;4;7;75
august-05;Santé;32;32;12;4;8;13;101
august-05;Sciences et techniques;26;20;15;7;9;14;91
august-05;Société;159;139;116;39;38;54;545
august-05;Sport;58;69;38;28;4;43;240
september-05;Catastrophes;115;102;51;19;32;46;365
september-05;Culture-loisirs;40;55;25;5;1;17;143
september-05;Economie;63;39;36;21;21;28;208
september-05;Education;16;19;7;3;0;3;48
september-05;Environnement;51;34;19;1;5;4;114
september-05;Faits divers;19;17;15;7;4;14;76
september-05;Histoire-hommages;7;10;4;4;5;3;33
september-05;International;65;71;45;25;133;29;368
september-05;Justice;25;24;20;11;12;13;105
september-05;Politique France;47;47;46;20;9;19;188
september-05;Santé;29;21;18;5;4;5;82
september-05;Sciences et techniques;10;17;8;4;3;5;47
september-05;Société;124;102;78;38;32;55;429
september-05;Sport;41;43;25;11;0;33;153
october-05;Catastrophes;47;49;30;8;39;22;195
october-05;Culture-loisirs;42;57;32;7;3;26;167
october-05;Economie;47;31;18;10;8;7;121
october-05;Education;15;8;5;1;0;1;30
october-05;Environnement;22;14;8;3;2;9;58
october-05;Faits divers;7;11;12;4;3;2;39
october-05;Histoire-hommages;10;6;8;0;2;5;31
october-05;International;69;70;59;27;114;29;368
october-05;Justice;40;40;34;20;16;17;167
october-05;Politique France;23;21;13;11;3;9;80
october-05;Santé;63;70;45;15;33;24;250
october-05;Sciences et techniques;24;22;12;4;7;8;77
october-05;Société;153;140;109;39;44;65;550
october-05;Sport;40;31;23;3;0;25;122
november-05;Catastrophes;29;22;9;1;13;15;89
november-05;Culture-loisirs;50;57;43;5;11;19;185
november-05;Economie;51;40;33;7;10;17;158
november-05;Education;17;16;8;5;2;3;51
november-05;Environnement;39;34;15;4;16;13;121
november-05;Faits divers;24;31;18;15;1;18;107
november-05;Histoire-hommages;18;12;13;1;4;1;49
november-05;International;67;74;39;24;127;21;352
november-05;Justice;45;39;40;18;19;25;186
november-05;Politique France;32;40;26;13;7;8;126
november-05;Santé;47;36;26;10;12;16;147
november-05;Sciences et techniques;20;20;10;1;1;8;60
november-05;Société;291;253;203;81;104;116;1048
november-05;Sport;47;48;22;8;0;33;158
december-05;Catastrophes;52;42;37;4;12;36;183
december-05;Culture-loisirs;60;50;30;5;3;18;166
december-05;Economie;61;64;30;18;9;19;201
december-05;Education;16;14;5;3;1;4;43
december-05;Environnement;29;37;14;6;9;8;103
december-05;Faits divers;17;13;20;7;2;8;67
december-05;Histoire-hommages;13;12;6;4;3;5;43
december-05;International;52;67;52;23;107;28;329
december-05;Justice;32;27;28;12;13;8;120
december-05;Politique France;24;16;17;5;0;16;78
december-05;Santé;19;19;12;1;4;7;62
december-05;Sciences et techniques;30;14;10;2;2;6;64
december-05;Société;186;166;104;38;56;60;610
december-05;Sport;29;27;21;5;2;26;110
january-06;Catastrophes;43;30;21;6;7;20;127
january-06;Culture-loisirs;52;63;38;11;4;33;201
january-06;Economie;47;39;26;8;20;15;155
january-06;Education;26;12;7;4;2;5;56
january-06;Environnement;42;46;24;4;8;15;139
january-06;Faits divers;31;32;20;6;2;18;109
january-06;Histoire-hommages;10;10;11;6;4;2;43
january-06;International;79;88;79;31;138;28;443
january-06;Justice;54;38;34;18;23;28;195
january-06;Politique France;26;28;26;11;20;10;121
january-06;Santé;50;42;24;9;27;15;167
january-06;Sciences et techniques;22;17;17;1;7;9;73
january-06;Société;159;142;100;34;43;55;533
january-06;Sport;40;42;26;5;2;35;150
february-06;Catastrophes;13;16;7;5;12;13;66
february-06;Culture-loisirs;42;47;26;11;2;21;149
february-06;Economie;46;44;18;11;11;18;148
february-06;Education;6;6;2;0;3;1;18
february-06;Environnement;32;21;19;8;9;11;100
february-06;Faits divers;32;28;27;10;7;12;116
february-06;Histoire-hommages;11;3;2;2;4;1;23
february-06;International;42;40;45;30;104;20;281
february-06;Justice;49;44;27;17;17;21;175
february-06;Politique France;29;21;23;9;11;8;101
february-06;Santé;99;94;54;29;38;36;350
february-06;Sciences et techniques;19;12;11;5;3;4;54
february-06;Société;124;104;76;40;55;58;457
february-06;Sport;45;69;42;5;5;42;208
march-06;Catastrophes;25;18;7;4;3;7;64
march-06;Culture-loisirs;46;48;28;12;2;16;152
march-06;Economie;37;29;18;9;12;7;112
march-06;Education;37;46;30;9;10;20;152
march-06;Environnement;40;24;20;4;18;6;112
march-06;Faits divers;16;8;13;6;3;12;58
march-06;Histoire-hommages;6;2;5;0;2;1;16
march-06;International;57;72;41;46;133;30;379
march-06;Justice;45;38;31;26;34;19;193
march-06;Politique France;32;16;22;10;3;8;91
march-06;Santé;59;50;21;12;19;15;176
march-06;Sciences et techniques;14;15;10;10;7;8;64
march-06;Société;211;230;147;60;67;78;793
march-06;Sport;47;42;23;7;2;23;144
april-06;Catastrophes;12;9;8;1;13;5;48
april-06;Culture-loisirs;37;66;24;11;2;16;156
april-06;Economie;53;51;37;15;10;19;185
april-06;Education;22;24;16;4;3;9;78
april-06;Environnement;39;26;13;3;8;9;98
april-06;Faits divers;19;15;11;4;4;16;69
april-06;Histoire-hommages;5;9;6;3;4;3;30
april-06;International;49;80;61;48;140;19;397
april-06;Justice;33;31;30;15;13;13;135
april-06;Politique France;20;27;26;6;13;7;99
april-06;Santé;39;31;29;5;7;12;123
april-06;Sciences et techniques;25;28;12;9;13;10;97
april-06;Société;196;163;112;50;55;67;643
april-06;Sport;47;53;30;7;1;32;170
may-06;Catastrophes;35;29;17;4;9;11;105
may-06;Culture-loisirs;63;60;43;6;5;23;200
may-06;Economie;64;49;30;14;13;13;183
may-06;Education;23;17;5;1;2;6;54
may-06;Environnement;34;33;18;4;9;11;109
may-06;Faits divers;20;15;16;6;8;16;81
may-06;Histoire-hommages;12;7;9;3;6;7;44
may-06;International;43;66;39;40;146;19;353
may-06;Justice;75;84;78;42;36;39;354
may-06;Politique France;37;35;25;15;17;7;136
may-06;Santé;27;29;19;3;11;10;99
may-06;Sciences et techniques;28;15;14;6;2;5;70
may-06;Société;157;127;70;52;37;44;487
may-06;Sport;61;50;28;19;4;23;185
june-06;Catastrophes;10;11;7;3;6;4;41
june-06;Culture-loisirs;41;41;31;14;0;19;146
june-06;Economie;33;39;37;11;17;13;150
june-06;Education;27;20;8;1;1;10;67
june-06;Environnement;32;23;9;4;6;11;85
june-06;Faits divers;26;21;20;5;3;13;88
june-06;Histoire-hommages;7;13;7;1;4;2;34
june-06;International;41;45;39;38;121;11;295
june-06;Justice;40;52;38;19;23;23;195
june-06;Politique France;29;46;31;11;11;16;144
june-06;Santé;18;15;14;4;5;9;65
june-06;Sciences et techniques;13;16;12;1;3;2;47
june-06;Société;109;120;76;29;40;34;408
june-06;Sport;218;163;79;26;29;75;590
july-06;Catastrophes;22;11;12;4;5;10;64
july-06;Culture-loisirs;41;59;37;9;2;18;166
july-06;Economie;31;31;17;3;8;9;99
july-06;Education;9;10;2;2;2;3;28
july-06;Environnement;46;42;23;2;5;14;132
july-06;Faits divers;9;17;18;0;0;7;51
july-06;Histoire-hommages;5;8;6;3;3;1;26
july-06;International;129;142;103;49;172;49;644
july-06;Justice;12;19;24;7;8;8;78
july-06;Politique France;23;18;19;10;6;9;85
july-06;Santé;29;32;23;9;3;13;109
july-06;Sciences et techniques;10;15;9;2;8;5;49
july-06;Société;82;104;84;29;36;42;377
july-06;Sport;174;161;96;20;27;83;561
august-06;Catastrophes;37;42;29;5;14;29;156
august-06;Culture-loisirs;37;60;32;8;3;16;156
august-06;Economie;56;45;28;6;8;9;152
august-06;Education;20;21;8;3;1;8;61
august-06;Environnement;57;33;35;9;17;10;161
august-06;Faits divers;22;23;16;4;1;11;77
august-06;Histoire-hommages;4;4;2;2;7;2;21
august-06;International;134;134;111;59;172;44;654
august-06;Justice;13;10;18;2;10;6;59
august-06;Politique France;37;49;38;21;14;25;184
august-06;Santé;25;22;13;7;10;10;87
august-06;Sciences et techniques;27;30;14;3;2;13;89
august-06;Société;107;84;78;24;42;43;378
august-06;Sport;65;58;42;21;1;37;224
september-06;Catastrophes;29;18;15;3;11;7;83
september-06;Culture-loisirs;37;55;38;15;1;13;159
september-06;Economie;49;48;25;10;15;13;160
september-06;Education;35;25;14;7;4;12;97
september-06;Environnement;32;29;17;8;10;6;102
september-06;Faits divers;19;29;23;13;5;14;103
september-06;Histoire-hommages;10;13;10;0;2;6;41
september-06;International;93;78;55;36;169;18;449
september-06;Justice;39;34;32;19;14;20;158
september-06;Politique France;63;51;49;20;14;19;216
september-06;Santé;35;35;24;9;3;13;119
september-06;Sciences et techniques;28;13;18;4;7;9;79
september-06;Société;134;113;80;36;41;53;457
september-06;Sport;47;42;15;11;0;28;143
october-06;Catastrophes;32;34;19;7;6;16;114
october-06;Culture-loisirs;58;77;36;13;7;18;209
october-06;Economie;57;44;27;8;21;15;172
october-06;Education;28;18;8;0;0;2;56
october-06;Environnement;55;32;14;6;9;7;123
october-06;Faits divers;16;23;12;11;5;20;87
october-06;Histoire-hommages;6;9;7;0;8;0;30
october-06;International;59;58;54;35;153;13;372
october-06;Justice;54;57;44;43;16;24;238
october-06;Politique France;55;54;50;20;20;21;220
october-06;Santé;50;45;26;1;5;10;137
october-06;Sciences et techniques;44;31;11;11;17;13;127
october-06;Société;190;153;131;54;80;73;681
october-06;Sport;55;48;28;22;1;35;189
november-06;Catastrophes;15;14;6;1;3;3;42
november-06;Culture-loisirs;36;54;28;19;2;17;156
november-06;Economie;53;47;22;4;14;14;154
november-06;Education;22;13;4;0;1;4;44
november-06;Environnement;30;34;11;1;8;8;92
november-06;Faits divers;15;20;9;5;1;10;60
november-06;Histoire-hommages;13;13;6;2;6;4;44
november-06;International;61;84;54;32;145;19;395
november-06;Justice;48;54;45;29;20;24;220
november-06;Politique France;53;53;35;27;13;20;201
november-06;Santé;23;22;17;5;4;5;76
november-06;Sciences et techniques;29;12;3;4;7;4;59
november-06;Société;142;134;95;30;54;53;508
november-06;Sport;59;60;33;20;2;32;206
december-06;Catastrophes;22;26;10;3;13;8;82
december-06;Culture-loisirs;53;70;34;16;5;16;194
december-06;Economie;58;45;21;12;14;19;169
december-06;Education;16;16;9;1;3;6;51
december-06;Environnement;31;27;14;3;6;4;85
december-06;Faits divers;33;37;28;12;9;20;139
december-06;Histoire-hommages;11;16;8;5;11;8;59
december-06;International;59;61;45;27;124;21;337
december-06;Justice;32;44;41;14;27;27;185
december-06;Politique France;36;38;44;17;13;11;159
december-06;Santé;23;21;13;4;6;6;73
december-06;Sciences et techniques;19;19;10;5;6;13;72
december-06;Société;186;166;116;36;37;46;587
december-06;Sport;31;47;15;10;1;16;120
january-07;Catastrophes;55;31;18;11;6;12;133
january-07;Culture-loisirs;68;80;45;21;2;27;243
january-07;Economie;49;49;39;11;12;15;175
january-07;Education;20;7;2;0;2;2;33
january-07;Environnement;80;69;39;10;14;21;233
january-07;Faits divers;33;32;34;18;3;26;146
january-07;Histoire-hommages;33;33;21;5;15;11;118
january-07;International;86;79;65;52;157;25;464
january-07;Justice;45;40;27;16;22;13;163
january-07;Politique France;67;73;70;34;15;42;301
january-07;Santé;51;39;21;8;7;8;134
january-07;Sciences et techniques;22;19;4;4;3;1;53
january-07;Société;200;156;94;43;60;52;605
january-07;Sport;59;67;37;17;1;29;210
february-07;Catastrophes;29;30;16;5;8;12;100
february-07;Culture-loisirs;59;68;41;20;6;26;220
february-07;Economie;71;47;43;17;28;18;224
february-07;Education;20;11;3;0;0;5;39
february-07;Environnement;61;29;22;8;10;12;142
february-07;Faits divers;30;15;20;12;3;14;94
february-07;Histoire-hommages;15;6;6;5;3;5;40
february-07;International;72;70;38;39;130;26;375
february-07;Justice;41;31;28;19;26;14;159
february-07;Politique France;79;79;70;34;16;40;318
february-07;Santé;39;39;14;6;16;13;127
february-07;Sciences et techniques;15;17;8;1;1;5;47
february-07;Société;128;102;69;24;43;32;398
february-07;Sport;50;60;34;8;6;20;178
march-07;Catastrophes;23;18;8;5;6;9;69
march-07;Culture-loisirs;53;56;27;7;2;12;157
march-07;Economie;72;34;28;11;16;13;174
march-07;Education;25;17;6;3;4;3;58
march-07;Environnement;44;30;10;5;12;8;109
march-07;Faits divers;25;19;17;6;3;19;89
march-07;Histoire-hommages;7;4;4;2;1;2;20
march-07;International;68;66;47;49;123;17;370
march-07;Justice;44;24;30;24;19;15;156
march-07;Politique France;96;119;75;49;29;51;419
march-07;Santé;31;25;14;6;3;6;85
march-07;Sciences et techniques;33;12;2;5;3;10;65
march-07;Société;155;115;80;44;46;47;487
march-07;Sport;53;63;29;20;0;26;191
april-07;Catastrophes;19;20;5;6;6;9;65
april-07;Culture-loisirs;30;30;25;6;0;14;105
april-07;Economie;37;19;10;5;11;5;87
april-07;Education;7;6;1;1;2;0;17
april-07;Environnement;37;24;8;6;9;8;92
april-07;Faits divers;42;50;40;21;6;27;186
april-07;Histoire-hommages;15;10;10;6;9;7;57
april-07;International;62;53;38;52;149;16;370
april-07;Justice;34;22;22;18;15;14;125
april-07;Politique France;133;148;118;49;39;74;561
april-07;Santé;26;23;11;7;0;9;76
april-07;Sciences et techniques;19;22;13;11;2;6;73
april-07;Société;127;107;51;33;32;36;386
april-07;Sport;46;40;20;13;0;28;147
may-07;Catastrophes;25;21;16;4;1;12;79
may-07;Culture-loisirs;61;73;52;9;4;27;226
may-07;Economie;45;37;16;16;19;14;147
may-07;Education;22;18;6;1;0;3;50
may-07;Environnement;60;52;14;9;10;11;156
may-07;Faits divers;26;19;18;10;0;12;85
may-07;Histoire-hommages;16;8;14;4;10;6;58
may-07;International;108;90;82;55;182;38;555
may-07;Justice;27;29;21;19;21;19;136
may-07;Politique France;148;168;126;49;38;83;612
may-07;Santé;32;14;10;4;1;5;66
may-07;Sciences et techniques;33;12;2;6;7;6;66
may-07;Société;167;114;89;41;49;58;518
may-07;Sport;58;53;29;24;3;27;194
june-07;Catastrophes;32;19;8;2;2;4;67
june-07;Culture-loisirs;38;43;25;20;7;11;144
june-07;Economie;46;38;24;11;8;5;132
june-07;Education;27;27;16;8;2;10;90
june-07;Environnement;38;39;25;12;9;10;133
june-07;Faits divers;23;14;15;13;0;12;77
june-07;Histoire-hommages;6;10;4;3;3;2;28
june-07;International;95;76;68;48;123;30;440
june-07;Justice;42;47;30;29;17;22;187
june-07;Politique France;96;97;64;34;18;43;352
june-07;Santé;27;15;8;8;5;5;68
june-07;Sciences et techniques;19;11;4;7;4;6;51
june-07;Société;137;93;60;55;33;51;429
june-07;Sport;69;59;34;27;2;28;219
july-07;Catastrophes;65;59;36;16;20;26;222
july-07;Culture-loisirs;53;84;55;15;1;24;232
july-07;Economie;65;49;47;14;29;16;220
july-07;Education;16;9;7;2;3;5;42
july-07;Environnement;62;55;24;7;17;27;192
july-07;Faits divers;28;18;19;10;4;9;88
july-07;Histoire-hommages;13;8;6;4;4;4;39
july-07;International;101;75;84;49;168;26;503
july-07;Justice;58;62;48;37;22;30;257
july-07;Politique France;48;37;32;7;10;16;150
july-07;Santé;22;18;15;8;5;14;82
july-07;Sciences et techniques;23;24;4;10;8;9;78
july-07;Société;169;146;90;42;43;69;559
july-07;Sport;105;112;76;33;10;43;379
august-07;Catastrophes;69;65;42;17;32;39;264
august-07;Culture-loisirs;52;45;22;6;7;12;144
august-07;Economie;57;55;42;15;23;12;204
august-07;Education;24;21;9;2;1;7;64
august-07;Environnement;53;36;15;5;8;8;125
august-07;Faits divers;22;30;22;11;6;16;107
august-07;Histoire-hommages;15;11;10;4;7;11;58
august-07;International;52;31;38;37;117;13;288
august-07;Justice;32;26;19;15;10;8;110
august-07;Politique France;33;25;27;8;8;13;114
august-07;Santé;15;7;3;5;8;5;43
august-07;Sciences et techniques;27;19;18;5;5;9;83
august-07;Société;129;127;88;34;53;54;485
august-07;Sport;89;74;43;27;5;36;274
september-07;Catastrophes;23;20;13;5;13;7;81
september-07;Culture-loisirs;46;54;31;18;5;26;180
september-07;Economie;52;45;29;23;20;11;180
september-07;Education;21;27;11;7;4;6;76
september-07;Environnement;34;28;5;5;16;4;92
september-07;Faits divers;26;28;12;12;4;25;107
september-07;Histoire-hommages;12;11;10;6;3;6;48
september-07;International;78;78;37;52;135;23;403
september-07;Justice;39;30;25;35;13;22;164
september-07;Politique France;55;42;40;23;14;23;197
september-07;Santé;25;21;19;7;2;8;82
september-07;Sciences et techniques;17;11;2;4;1;4;39
september-07;Société;123;133;70;52;41;38;457
september-07;Sport;131;78;47;14;9;39;318
october-07;Catastrophes;37;26;21;11;11;13;119
october-07;Culture-loisirs;60;61;42;33;6;32;234
october-07;Economie;54;46;20;21;13;11;165
october-07;Education;21;18;8;3;2;7;59
october-07;Environnement;40;53;20;11;9;9;142
october-07;Faits divers;37;25;11;12;4;16;105
october-07;Histoire-hommages;8;5;7;4;8;2;34
october-07;International;114;114;64;71;178;28;569
october-07;Justice;68;51;56;52;17;29;273
october-07;Politique France;50;44;39;19;12;16;180
october-07;Santé;30;36;9;9;1;9;94
october-07;Sciences et techniques;22;10;10;1;2;8;53
october-07;Société;176;179;88;69;54;61;627
october-07;Sport;146;118;69;30;7;53;423
november-07;Catastrophes;29;28;12;10;12;10;101
november-07;Culture-loisirs;43;41;27;16;3;16;146
november-07;Economie;44;51;26;29;17;15;182
november-07;Education;41;40;18;14;8;13;134
november-07;Environnement;26;24;8;5;9;7;79
november-07;Faits divers;21;17;20;14;1;14;87
november-07;Histoire-hommages;16;14;10;5;5;3;53
november-07;International;103;91;55;56;142;38;485
november-07;Justice;52;45;43;30;12;28;210
november-07;Politique France;33;21;15;11;5;3;88
november-07;Santé;21;6;8;5;2;8;50
november-07;Sciences et techniques;13;5;6;2;4;4;34
november-07;Société;203;192;109;81;50;70;705
november-07;Sport;51;36;20;13;2;18;140
december-07;Catastrophes;23;17;14;5;3;2;64
december-07;Culture-loisirs;68;57;35;17;8;25;210
december-07;Economie;61;49;38;20;13;18;199
december-07;Education;17;9;5;1;0;1;33
december-07;Environnement;56;36;18;10;16;9;145
december-07;Faits divers;38;33;16;15;4;23;129
december-07;Histoire-hommages;10;7;4;5;2;2;30
december-07;International;109;117;69;72;149;48;564
december-07;Justice;65;51;45;36;16;37;250
december-07;Politique France;46;35;30;13;10;16;150
december-07;Santé;24;20;19;8;5;11;87
december-07;Sciences et techniques;18;12;3;7;5;6;51
december-07;Société;159;149;81;63;52;46;550
december-07;Sport;50;40;19;7;0;17;133
january-08;Catastrophes;24;14;10;3;2;4;57
january-08;Culture-loisirs;76;80;53;34;9;33;285
january-08;Economie;83;89;44;26;29;24;295
january-08;Education;11;11;5;4;2;2;35
january-08;Environnement;38;32;16;4;5;7;102
january-08;Faits divers;45;36;30;17;0;27;155
january-08;Histoire-hommages;21;15;11;7;9;7;70
january-08;International;151;144;98;80;212;41;726
january-08;Justice;58;55;36;32;21;29;231
january-08;Politique France;72;65;50;21;10;30;248
january-08;Santé;44;47;30;14;6;16;157
january-08;Sciences et techniques;19;15;5;3;1;4;47
january-08;Société;166;126;73;65;43;67;540
january-08;Sport;91;81;40;22;3;28;265
february-08;Catastrophes;15;10;5;3;4;8;45
february-08;Culture-loisirs;68;72;47;26;9;25;247
february-08;Economie;73;69;30;27;18;17;234
february-08;Education;20;13;11;5;2;7;58
february-08;Environnement;28;13;9;13;3;3;69
february-08;Faits divers;19;9;11;11;3;16;69
february-08;Histoire-hommages;15;9;2;5;2;4;37
february-08;International;103;102;70;73;166;36;550
february-08;Justice;43;46;32;34;18;20;193
february-08;Politique France;55;53;53;22;15;26;224
february-08;Santé;21;21;11;10;3;11;77
february-08;Sciences et techniques;36;11;5;5;3;9;69
february-08;Société;136;96;72;53;35;49;441
february-08;Sport;56;57;31;17;0;27;188
march-08;Catastrophes;16;24;10;4;1;6;61
march-08;Culture-loisirs;51;44;29;14;2;19;159
march-08;Economie;68;51;29;27;14;15;204
march-08;Education;17;12;2;3;4;5;43
march-08;Environnement;38;21;26;12;7;14;118
march-08;Faits divers;22;18;13;16;2;9;80
march-08;Histoire-hommages;14;21;10;7;8;5;65
march-08;International;95;99;52;61;152;27;486
march-08;Justice;39;43;35;39;15;29;200
march-08;Politique France;58;67;68;42;13;37;285
march-08;Santé;24;19;16;13;7;20;99
march-08;Sciences et techniques;33;13;8;4;6;3;67
march-08;Société;134;98;45;61;42;43;423
march-08;Sport;69;72;35;20;6;33;235
april-08;Catastrophes;19;18;12;5;2;10;66
april-08;Culture-loisirs;57;55;42;19;2;31;206
april-08;Economie;98;83;42;38;46;29;336
april-08;Education;27;28;20;19;7;16;117
april-08;Environnement;26;34;13;1;4;10;88
april-08;Faits divers;47;41;38;29;12;36;203
april-08;Histoire-hommages;31;28;26;12;7;8;112
april-08;International;87;98;65;80;178;23;531
april-08;Justice;37;41;34;28;11;23;174
april-08;Politique France;41;37;34;25;22;10;169
april-08;Santé;32;31;12;11;6;19;111
april-08;Sciences et techniques;31;19;4;6;2;10;72
april-08;Société;147;148;79;57;50;51;532
april-08;Sport;115;115;54;51;26;55;416
may-08;Catastrophes;85;84;53;36;44;29;331
may-08;Culture-loisirs;53;59;41;18;2;27;200
may-08;Economie;79;75;46;30;34;15;279
may-08;Education;19;18;8;4;5;7;61
may-08;Environnement;22;23;8;3;5;2;63
may-08;Faits divers;24;19;18;13;0;24;98
may-08;Histoire-hommages;23;21;11;8;11;12;86
may-08;International;58;56;31;48;130;17;340
may-08;Justice;29;24;26;25;11;15;130
may-08;Politique France;35;39;25;16;9;9;133
may-08;Santé;15;16;9;4;2;5;51
may-08;Sciences et techniques;18;5;7;3;1;1;35
may-08;Société;147;119;75;51;32;40;464
may-08;Sport;69;56;28;22;6;34;215
june-08;Catastrophes;56;45;20;19;17;19;176
june-08;Culture-loisirs;40;69;32;16;8;21;186
june-08;Economie;79;62;50;25;23;18;257
june-08;Education;19;23;16;7;5;12;82
june-08;Environnement;34;20;5;4;13;1;77
june-08;Faits divers;20;39;19;17;5;21;121
june-08;Histoire-hommages;13;7;4;6;3;1;34
june-08;International;64;96;61;69;150;17;457
june-08;Justice;32;23;25;17;9;19;125
june-08;Politique France;25;29;23;11;6;5;99
june-08;Santé;24;15;18;7;1;6;71
june-08;Sciences et techniques;8;10;9;5;4;5;41
june-08;Société;131;97;68;53;43;45;437
june-08;Sport;99;91;45;26;7;57;325
july-08;Catastrophes;28;31;13;15;2;15;104
july-08;Culture-loisirs;81;75;43;16;6;25;246
july-08;Economie;65;63;34;17;31;23;233
july-08;Education;16;11;2;5;2;6;42
july-08;Environnement;43;30;20;9;5;11;118
july-08;Faits divers;51;59;35;33;3;44;225
july-08;Histoire-hommages;11;6;3;5;2;2;29
july-08;International;99;111;74;84;203;37;608
july-08;Justice;32;28;30;24;19;16;149
july-08;Politique France;70;80;54;29;20;27;280
july-08;Santé;24;22;8;11;0;7;72
july-08;Sciences et techniques;32;23;17;12;11;18;113
july-08;Société;134;99;77;52;53;63;478
july-08;Sport;104;113;70;54;12;44;397
august-08;Catastrophes;48;50;24;15;11;22;170
august-08;Culture-loisirs;38;51;20;11;1;20;141
august-08;Economie;43;40;28;18;14;12;155
august-08;Education;19;7;4;4;;2;36
august-08;Environnement;20;17;14;6;6;5;68
august-08;Faits divers;27;18;12;11;2;18;88
august-08;Histoire-hommages;8;13;11;6;7;4;49
august-08;International;115;119;92;74;151;45;596
august-08;Justice;18;24;20;13;17;12;104
august-08;Politique France;14;16;11;4;3;10;58
august-08;Santé;19;17;9;7;2;8;62
august-08;Sciences et techniques;9;12;5;11;3;6;46
august-08;Société;92;76;63;37;39;41;348
august-08;Sport;128;149;88;56;17;63;501
september-08;Catastrophes;49;49;33;20;21;27;199
september-08;Culture-loisirs;55;72;50;20;5;28;230
september-08;Economie;122;127;76;62;65;45;497
september-08;Education;40;26;10;12;3;19;110
september-08;Environnement;32;29;17;7;3;9;97
september-08;Faits divers;51;57;38;20;6;31;203
september-08;Histoire-hommages;9;14;2;4;6;4;39
september-08;International;75;107;64;79;158;35;518
september-08;Justice;26;25;16;22;6;14;109
september-08;Politique France;43;60;47;25;12;16;203
september-08;Santé;42;35;14;11;5;20;127
september-08;Sciences et techniques;18;13;7;6;10;6;60
september-08;Société;125;112;75;69;38;50;469
september-08;Sport;63;59;23;16;1;32;194
october-08;Catastrophes;7;5;4;6;5;3;30
october-08;Culture-loisirs;51;65;33;18;4;25;196
october-08;Economie;128;154;97;85;76;66;606
october-08;Education;14;6;6;5;4;6;41
october-08;Environnement;27;19;4;1;8;5;64
october-08;Faits divers;22;15;11;15;1;12;76
october-08;Histoire-hommages;25;20;14;10;7;10;86
october-08;International;55;72;34;69;109;12;351
october-08;Justice;49;49;37;36;20;34;225
october-08;Politique France;19;27;18;5;4;6;79
october-08;Santé;29;31;15;9;2;13;99
october-08;Sciences et techniques;11;4;4;1;3;6;29
october-08;Société;115;97;63;53;30;59;417
october-08;Sport;47;45;22;13;1;23;151
november-08;Catastrophes;27;28;13;6;5;10;89
november-08;Culture-loisirs;55;50;38;24;2;27;196
november-08;Economie;79;66;46;45;51;28;315
november-08;Education;12;8;6;2;4;4;36
november-08;Environnement;20;21;9;5;3;9;67
november-08;Faits divers;42;35;26;34;8;25;170
november-08;Histoire-hommages;8;11;6;3;6;5;39
november-08;International;102;139;61;69;130;35;536
november-08;Justice;26;28;24;29;18;19;144
november-08;Politique France;41;57;43;38;14;23;216
november-08;Santé;21;15;7;7;2;8;60
november-08;Sciences et techniques;11;11;9;6;6;10;53
november-08;Société;133;111;63;74;38;64;483
november-08;Sport;56;45;20;19;0;27;167
december-08;Catastrophes;43;40;14;9;2;13;121
december-08;Culture-loisirs;83;75;53;27;7;39;284
december-08;Economie;91;104;59;47;47;26;374
december-08;Education;19;14;19;7;1;9;69
december-08;Environnement;62;55;27;14;10;10;178
december-08;Faits divers;48;46;39;36;10;43;222
december-08;Histoire-hommages;5;3;3;4;5;4;24
december-08;International;88;104;74;88;165;29;548
december-08;Justice;38;52;29;52;22;26;219
december-08;Politique France;20;34;23;19;7;14;117
december-08;Santé;42;43;16;15;10;21;147
december-08;Sciences et techniques;8;8;8;3;4;2;33
december-08;Société;172;137;100;80;55;75;619
december-08;Sport;51;54;37;20;0;36;198
january-09;Catastrophes;70;66;41;18;5;33;233
january-09;Culture-loisirs;47;48;37;18;2;25;177
january-09;Economie;52;44;30;41;42;19;228
january-09;Education;19;12;12;8;5;13;69
january-09;Environnement;22;20;13;15;2;14;86
january-09;Faits divers;29;26;17;28;5;24;129
january-09;Histoire-hommages;10;7;4;4;5;1;31
january-09;International;93;135;92;93;150;56;619
january-09;Justice;21;19;16;22;8;11;97
january-09;Politique France;26;22;17;11;6;12;94
january-09;Santé;27;30;14;13;5;15;104
january-09;Sciences et techniques;11;2;8;0;2;3;26
january-09;Société;110;97;67;70;34;38;416
january-09;Sport;40;51;21;17;0;24;153
february-09;Catastrophes;49;33;21;16;7;15;141
february-09;Culture-loisirs;47;40;31;21;5;29;173
february-09;Economie;99;83;51;62;49;38;382
february-09;Education;16;19;9;12;5;5;66
february-09;Environnement;15;25;7;12;2;6;67
february-09;Faits divers;26;33;18;26;2;20;125
february-09;Histoire-hommages;7;4;4;3;10;1;29
february-09;International;46;52;40;54;127;23;342
february-09;Justice;44;45;44;54;13;36;236
february-09;Politique France;15;25;14;12;5;9;80
february-09;Santé;17;15;7;4;2;12;57
february-09;Sciences et techniques;15;6;7;4;1;8;41
february-09;Société;133;126;94;66;56;69;544
february-09;Sport;51;48;32;16;0;28;175
march-09;Catastrophes;23;17;12;12;1;19;84
march-09;Culture-loisirs;67;65;50;29;5;33;249
march-09;Economie;101;116;93;76;53;40;479
march-09;Education;27;15;15;7;8;10;82
march-09;Environnement;40;19;12;6;10;9;96
march-09;Faits divers;37;33;27;23;11;27;158
march-09;Histoire-hommages;9;14;7;4;6;5;45
march-09;International;66;89;51;81;153;25;465
march-09;Justice;41;57;45;56;36;30;265
march-09;Politique France;25;33;23;10;6;13;110
march-09;Santé;34;38;14;8;4;16;114
march-09;Sciences et techniques;22;14;10;11;8;10;75
march-09;Société;174;146;113;86;47;93;659
march-09;Sport;64;56;21;9;1;28;179
april-09;Catastrophes;35;32;23;17;10;20;137
april-09;Culture-loisirs;48;53;36;21;6;26;190
april-09;Economie;52;49;44;23;38;33;239
april-09;Education;11;11;8;4;2;6;42
april-09;Environnement;11;7;3;0;6;4;31
april-09;Faits divers;21;28;24;15;5;21;114
april-09;Histoire-hommages;8;9;7;8;5;4;41
april-09;International;72;93;69;66;142;41;483
april-09;Justice;27;27;26;30;6;19;135
april-09;Politique France;19;22;18;12;4;12;87
april-09;Santé;65;66;31;21;13;18;214
april-09;Sciences et techniques;15;7;6;6;3;2;39
april-09;Société;116;108;81;54;29;71;459
april-09;Sport;37;37;25;15;1;20;135
may-09;Catastrophes;14;16;14;7;5;8;64
may-09;Culture-loisirs;61;68;47;24;3;34;237
may-09;Economie;53;53;30;25;36;20;217
may-09;Education;31;28;16;20;1;15;111
may-09;Environnement;32;21;7;6;1;6;73
may-09;Faits divers;40;37;33;22;3;28;163
may-09;Histoire-hommages;13;12;7;7;11;6;56
may-09;International;71;72;74;56;142;17;432
may-09;Justice;26;41;29;17;11;20;144
may-09;Politique France;10;22;11;4;3;3;53
may-09;Santé;43;51;34;11;12;21;172
may-09;Sciences et techniques;18;15;8;7;1;10;59
may-09;Société;128;121;75;63;50;63;500
may-09;Sport;43;52;26;15;1;31;168
june-09;Catastrophes;128;131;71;58;22;42;452
june-09;Culture-loisirs;56;48;35;16;3;25;183
june-09;Economie;54;45;29;19;48;20;215
june-09;Education;19;14;10;5;4;12;64
june-09;Environnement;11;14;8;2;7;7;49
june-09;Faits divers;20;15;15;17;6;16;89
june-09;Histoire-hommages;65;64;28;22;12;22;213
june-09;International;79;120;96;74;197;25;591
june-09;Justice;36;33;33;27;15;31;175
june-09;Politique France;45;53;39;18;8;10;173
june-09;Santé;58;38;23;8;5;15;147
june-09;Sciences et techniques;9;5;2;2;2;5;25
june-09;Société;103;73;63;41;31;56;367
june-09;Sport;72;62;34;14;0;46;228
july-09;Catastrophes;56;57;42;26;6;23;210
july-09;Culture-loisirs;63;56;32;20;8;23;202
july-09;Economie;47;47;30;17;26;22;189
july-09;Education;7;8;8;2;0;6;31
july-09;Environnement;33;21;13;14;9;9;99
july-09;Faits divers;35;36;18;18;1;24;132
july-09;Histoire-hommages;52;35;8;14;9;11;129
july-09;International;29;47;41;49;146;10;322
july-09;Justice;15;20;24;25;12;10;106
july-09;Politique France;36;38;34;22;10;19;159
july-09;Santé;33;38;23;12;6;18;130
july-09;Sciences et techniques;27;25;16;9;10;11;98
july-09;Société;91;82;60;58;38;39;368
july-09;Sport;66;67;37;34;0;40;244
august-09;Catastrophes;33;48;28;19;10;21;159
august-09;Culture-loisirs;62;33;29;12;1;27;164
august-09;Economie;80;67;47;33;26;19;272
august-09;Education;14;7;8;3;2;5;39
august-09;Environnement;43;30;16;9;6;10;114
august-09;Faits divers;40;40;39;34;9;40;202
august-09;Histoire-hommages;19;19;8;10;13;6;75
august-09;International;51;75;56;56;131;25;394
august-09;Justice;18;16;10;21;16;7;88
august-09;Politique France;26;27;24;14;6;12;109
august-09;Santé;36;33;34;22;11;23;159
august-09;Sciences et techniques;7;8;5;2;3;2;27
august-09;Société;87;92;44;40;26;49;338
august-09;Sport;58;49;24;17;0;25;173
september-09;Catastrophes;57;41;28;13;8;18;165
september-09;Culture-loisirs;74;70;42;17;2;41;246
september-09;Economie;80;69;54;47;37;34;321
september-09;Education;28;22;6;10;3;17;86
september-09;Environnement;35;27;23;14;9;15;123
september-09;Faits divers;30;39;28;26;3;22;148
september-09;Histoire-hommages;11;21;6;9;12;14;73
september-09;International;57;88;55;60;186;43;489
september-09;Justice;50;45;44;38;17;44;238
september-09;Politique France;54;51;44;32;16;32;229
september-09;Santé;59;58;48;25;7;35;232
september-09;Sciences et techniques;22;10;6;1;6;5;50
september-09;Société;88;108;62;66;29;72;425
september-09;Sport;70;55;20;25;4;58;232
october-09;Catastrophes;34;30;19;11;5;14;113
october-09;Culture-loisirs;53;51;38;11;3;19;175
october-09;Economie;55;50;25;30;24;24;208
october-09;Education;10;15;8;5;3;10;51
october-09;Environnement;26;18;14;10;11;4;83
october-09;Faits divers;19;18;12;18;0;18;85
october-09;Histoire-hommages;4;6;3;3;7;3;26
october-09;International;44;63;50;46;145;42;390
october-09;Justice;67;54;50;62;20;65;318
october-09;Politique France;36;54;28;21;14;41;194
october-09;Santé;45;24;20;17;11;18;135
october-09;Sciences et techniques;16;12;12;5;11;10;66
october-09;Société;103;79;75;61;30;86;434
october-09;Sport;61;42;25;15;0;50;193
november-09;Catastrophes;34;21;14;4;5;13;91
november-09;Culture-loisirs;51;45;32;11;4;16;159
november-09;Economie;45;35;23;13;17;32;165
november-09;Education;6;4;7;3;1;0;21
november-09;Environnement;27;22;9;8;9;9;84
november-09;Faits divers;43;43;22;20;2;46;176
november-09;Histoire-hommages;26;32;39;10;31;17;155
november-09;International;29;45;37;48;111;36;306
november-09;Justice;38;36;38;26;24;42;204
november-09;Politique France;27;34;32;19;10;18;140
november-09;Santé;58;63;37;24;8;33;223
november-09;Sciences et techniques;13;11;3;1;6;2;36
november-09;Société;105;88;50;50;40;81;414
november-09;Sport;75;56;25;30;5;76;267
december-09;Catastrophes;63;45;30;13;3;29;183
december-09;Culture-loisirs;61;65;43;9;4;26;208
december-09;Economie;62;46;28;17;36;26;215
december-09;Education;6;4;5;2;4;2;23
december-09;Environnement;63;53;58;27;32;29;262
december-09;Faits divers;50;53;41;23;5;55;227
december-09;Histoire-hommages;5;10;7;5;11;3;41
december-09;International;52;72;51;60;150;40;425
december-09;Justice;53;26;25;17;20;39;180
december-09;Politique France;23;27;11;4;5;22;92
december-09;Santé;54;57;35;21;9;45;221
december-09;Sciences et techniques;6;10;3;3;3;3;28
december-09;Société;159;166;101;76;49;122;673
december-09;Sport;43;43;16;16;0;56;174
january-10;Catastrophes;162;129;93;54;40;94;572
january-10;Culture-loisirs;50;38;31;8;60;23;210
january-10;Economie;37;28;21;19;26;33;164
january-10;Education;18;12;14;7;0;9;60
january-10;Environnement;36;24;16;6;5;16;103
january-10;Faits divers;22;18;19;7;0;28;94
january-10;Histoire-hommages;10;21;18;10;6;9;74
january-10;International;42;54;36;50;96;36;314
january-10;Justice;28;20;8;13;15;15;99
january-10;Politique France;37;29;31;17;6;19;139
january-10;Santé;20;16;20;6;8;16;86
january-10;Sciences et techniques;9;4;2;4;3;4;26
january-10;Société;104;96;64;62;45;73;444
january-10;Sport;48;37;12;2;1;37;137
february-10;Catastrophes;65;52;37;26;11;35;226
february-10;Culture-loisirs;56;42;25;18;96;21;258
february-10;Economie;47;39;21;27;32;26;192
february-10;Education;25;15;17;15;4;15;91
february-10;Environnement;34;20;13;4;3;13;87
february-10;Faits divers;28;16;21;12;8;27;112
february-10;Histoire-hommages;13;4;8;8;7;6;46
february-10;International;34;47;36;44;81;31;273
february-10;Justice;29;24;31;10;10;27;131
february-10;Politique France;38;43;31;14;6;20;152
february-10;Santé;14;11;9;7;3;11;55
february-10;Sciences et techniques;11;12;3;5;4;7;42
february-10;Société;111;134;73;70;49;83;520
february-10;Sport;60;69;26;12;4;61;232
march-10;Catastrophes;134;98;78;42;11;69;432
march-10;Culture-loisirs;50;47;29;13;90;27;256
march-10;Economie;48;50;31;25;56;24;234
march-10;Education;14;12;8;5;3;12;54
march-10;Environnement;33;25;22;10;9;18;117
march-10;Faits divers;30;29;20;24;8;37;148
march-10;Histoire-hommages;15;15;7;4;6;5;52
march-10;International;37;49;43;43;123;30;325
march-10;Justice;39;38;31;28;17;34;187
march-10;Politique France;75;98;75;32;20;69;369
march-10;Santé;22;23;13;8;3;21;90
march-10;Sciences et techniques;10;6;5;6;5;6;38
march-10;Société;126;88;77;65;51;86;493
march-10;Sport;46;65;24;19;0;60;214
april-10;Catastrophes;87;68;46;21;20;50;292
april-10;Culture-loisirs;51;39;22;6;74;27;219
april-10;Economie;41;42;26;18;21;34;182
april-10;Education;16;10;6;3;4;12;51
april-10;Environnement;29;28;21;11;5;13;107
april-10;Faits divers;26;18;22;16;0;35;117
april-10;Histoire-hommages;12;18;13;8;13;13;77
april-10;International;33;50;38;40;112;20;293
april-10;Justice;31;21;23;26;11;30;142
april-10;Politique France;15;12;4;5;2;7;45
april-10;Santé;15;18;18;4;0;12;67
april-10;Sciences et techniques;9;4;3;0;4;7;27
april-10;Société;184;174;125;78;56;129;746
april-10;Sport;39;33;16;14;0;44;146
may-10;Catastrophes;30;23;17;13;14;19;116
may-10;Culture-loisirs;53;49;37;11;79;37;266
may-10;Economie;49;79;34;29;37;52;280
may-10;Education;11;12;9;3;0;10;45
may-10;Environnement;74;47;39;23;23;40;246
may-10;Faits divers;39;27;21;19;1;33;140
may-10;Histoire-hommages;9;8;6;0;7;3;33
may-10;International;52;87;51;54;92;39;375
may-10;Justice;26;37;22;21;5;32;143
may-10;Politique France;15;14;9;3;2;16;59
may-10;Santé;21;17;13;5;6;11;73
may-10;Sciences et techniques;11;2;3;3;3;3;25
may-10;Société;123;95;76;53;38;60;445
may-10;Sport;64;66;31;18;0;56;235
june-10;Catastrophes;64;45;33;28;8;41;219
june-10;Culture-loisirs;35;32;31;11;86;23;218
june-10;Economie;36;38;36;16;20;29;175
june-10;Education;19;16;10;6;5;11;67
june-10;Environnement;40;20;12;9;21;20;122
june-10;Faits divers;37;28;19;20;3;40;147
june-10;Histoire-hommages;17;18;15;10;7;14;81
june-10;International;58;68;65;53;150;36;430
june-10;Justice;25;38;39;30;17;39;188
june-10;Politique France;33;52;33;19;8;22;167
june-10;Santé;17;11;9;8;4;10;59
june-10;Sciences et techniques;6;6;5;6;2;6;31
june-10;Société;100;86;79;42;28;70;405
june-10;Sport;178;160;93;76;17;127;651
july-10;Catastrophes;38;28;20;18;9;31;144
july-10;Culture-loisirs;59;51;40;14;90;28;282
july-10;Economie;31;23;14;11;17;19;115
july-10;Education;5;5;3;3;2;8;26
july-10;Environnement;43;29;20;11;16;23;142
july-10;Faits divers;32;28;22;14;7;26;129
july-10;Histoire-hommages;10;20;10;4;3;10;57
july-10;International;29;64;55;35;87;27;297
july-10;Justice;25;40;20;36;10;44;175
july-10;Politique France;65;64;51;36;17;36;269
july-10;Santé;26;26;14;11;2;21;100
july-10;Sciences et techniques;12;4;3;4;2;7;32
july-10;Société;83;87;65;52;32;86;405
july-10;Sport;74;85;61;44;5;69;338
august-10;Catastrophes;75;88;69;61;55;58;406
august-10;Culture-loisirs;65;51;41;11;84;32;284
august-10;Economie;67;66;32;26;19;36;246
august-10;Education;24;20;17;5;1;19;86
august-10;Environnement;50;29;14;10;19;20;142
august-10;Faits divers;37;28;23;15;3;35;141
august-10;Histoire-hommages;13;6;3;4;8;4;38
august-10;International;37;71;57;35;99;37;336
august-10;Justice;22;27;25;15;4;28;121
august-10;Politique France;59;73;46;51;18;46;293
august-10;Santé;16;13;16;6;3;12;66
august-10;Sciences et techniques;12;9;8;4;2;8;43
august-10;Société;138;105;80;60;28;82;493
august-10;Sport;80;73;55;41;0;64;313
september-10;Catastrophes;25;24;15;10;9;20;103
september-10;Culture-loisirs;60;45;40;9;74;37;265
september-10;Economie;45;32;29;20;13;19;158
september-10;Education;19;11;8;3;1;9;51
september-10;Environnement;19;14;5;7;2;4;51
september-10;Faits divers;19;19;20;9;3;27;97
september-10;Histoire-hommages;17;12;13;7;13;13;75
september-10;International;70;98;81;58;115;43;465
september-10;Justice;24;27;29;24;4;29;137
september-10;Politique France;40;45;26;23;11;28;173
september-10;Santé;24;24;17;5;1;17;88
september-10;Sciences et techniques;12;9;4;4;7;3;39
september-10;Société;123;114;106;80;51;90;564
september-10;Sport;43;35;20;10;0;40;148
october-10;Catastrophes;31;27;14;15;12;28;127
october-10;Culture-loisirs;52;43;35;10;86;42;268
october-10;Economie;32;32;18;12;16;14;124
october-10;Education;9;5;2;2;0;1;19
october-10;Environnement;28;16;18;8;12;14;96
october-10;Faits divers;22;16;26;13;0;25;102
october-10;Histoire-hommages;10;9;6;3;7;3;38
october-10;International;28;61;44;36;94;16;279
october-10;Justice;24;24;34;24;8;27;141
october-10;Politique France;12;11;9;4;5;6;47
october-10;Santé;19;24;15;10;4;16;88
october-10;Sciences et techniques;12;9;6;1;4;13;45
october-10;Société;229;261;186;117;67;137;997
october-10;Sport;37;32;18;6;0;18;111
november-10;Catastrophes;61;67;50;20;6;41;245
november-10;Culture-loisirs;65;46;29;14;88;48;290
november-10;Economie;57;44;45;24;36;23;229
november-10;Education;16;17;13;5;3;10;64
november-10;Environnement;60;45;43;16;6;13;183
november-10;Faits divers;43;38;36;20;7;42;186
november-10;Histoire-hommages;15;7;6;6;8;8;50
november-10;International;72;101;93;56;117;49;488
november-10;Justice;35;32;35;25;13;31;171
november-10;Politique France;66;88;58;28;14;29;283
november-10;Santé;30;32;31;10;11;18;132
november-10;Sciences et techniques;19;15;8;7;15;11;75
november-10;Société;122;156;96;74;49;120;617
november-10;Sport;58;55;36;11;1;42;203
december-10;Catastrophes;134;109;98;37;8;59;445
december-10;Culture-loisirs;70;36;22;8;65;39;240
december-10;Economie;35;35;26;14;19;24;153
december-10;Education;6;10;4;4;4;6;34
december-10;Environnement;26;27;21;12;7;26;119
december-10;Faits divers;22;16;20;18;0;24;100
december-10;Histoire-hommages;5;8;2;6;6;4;31
december-10;International;56;102;94;48;110;46;456
december-10;Justice;24;37;30;25;18;26;160
december-10;Politique France;27;31;32;7;4;8;109
december-10;Santé;17;22;22;5;2;14;82
december-10;Sciences et techniques;6;5;3;3;0;5;22
december-10;Société;115;98;73;47;33;63;429
december-10;Sport;23;20;9;6;1;15;74
january-11;Catastrophes;41;32;28;21;8;25;155
january-11;Culture-loisirs;60;41;37;5;75;56;274
january-11;Economie;50;27;24;18;20;16;155
january-11;Education;13;12;8;4;1;11;49
january-11;Environnement;14;8;9;3;1;7;42
january-11;Faits divers;38;43;37;16;4;44;182
january-11;Histoire-hommages;13;8;6;1;5;3;36
january-11;International;145;201;133;82;153;99;813
january-11;Justice;24;28;23;20;3;18;116
january-11;Politique France;29;46;31;9;4;16;135
january-11;Santé;33;27;22;13;5;28;128
january-11;Sciences et techniques;6;6;9;2;1;3;27
january-11;Société;89;83;55;38;23;66;354
january-11;Sport;36;39;16;2;1;13;107
february-11;Catastrophes;25;18;19;13;2;10;87
february-11;Culture-loisirs;50;37;20;5;73;42;227
february-11;Economie;49;44;36;14;5;18;166
february-11;Education;9;8;12;5;0;7;41
february-11;Environnement;18;11;7;1;0;11;48
february-11;Faits divers;48;43;45;18;1;56;211
february-11;Histoire-hommages;8;9;3;2;9;2;33
february-11;International;160;225;142;110;187;86;910
february-11;Justice;40;43;38;35;8;37;201
february-11;Politique France;30;42;21;24;4;16;137
february-11;Santé;25;19;12;8;4;20;88
february-11;Sciences et techniques;11;5;8;5;3;9;41
february-11;Société;78;52;50;33;22;65;300
february-11;Sport;43;52;25;12;0;31;163
march-11;Catastrophes;94;83;58;44;16;77;372
march-11;Culture-loisirs;59;45;22;4;79;50;259
march-11;Economie;62;37;29;21;7;39;195
march-11;Education;9;11;5;3;1;9;38
march-11;Environnement;120;121;69;28;48;80;466
march-11;Faits divers;30;36;30;14;1;41;152
march-11;Histoire-hommages;15;12;10;3;4;7;51
march-11;International;179;218;142;105;193;97;934
march-11;Justice;19;24;22;19;9;27;120
march-11;Politique France;77;123;83;29;8;47;367
march-11;Santé;31;11;21;9;0;18;90
march-11;Sciences et techniques;7;13;7;2;7;9;45
march-11;Société;70;51;49;44;14;52;280
march-11;Sport;41;42;15;5;0;17;120
april-11;Catastrophes;22;20;15;12;5;16;90
april-11;Culture-loisirs;56;40;24;7;55;46;228
april-11;Economie;49;48;32;21;13;29;192
april-11;Education;10;5;8;1;1;1;26
april-11;Environnement;56;30;31;7;19;21;164
april-11;Faits divers;58;48;44;19;1;48;218
april-11;Histoire-hommages;6;5;3;1;6;3;24
april-11;International;115;184;114;91;163;64;731
april-11;Justice;18;22;21;16;8;22;107
april-11;Politique France;22;43;34;15;3;16;133
april-11;Santé;18;19;25;7;1;22;92
april-11;Sciences et techniques;12;10;11;6;12;6;57
april-11;Société;122;101;75;37;28;95;458
april-11;Sport;37;32;16;2;1;10;98
may-11;Catastrophes;44;33;22;21;4;17;141
may-11;Culture-loisirs;57;52;33;5;92;50;289
may-11;Economie;44;27;26;15;16;21;149
may-11;Education;20;18;11;3;3;10;65
may-11;Environnement;48;44;27;15;21;31;186
may-11;Faits divers;27;20;25;8;1;35;116
may-11;Histoire-hommages;16;15;15;5;10;10;71
may-11;International;120;157;128;86;172;94;757
may-11;Justice;131;130;81;51;25;78;496
may-11;Politique France;64;71;48;29;4;44;260
may-11;Santé;36;44;36;15;7;35;173
may-11;Sciences et techniques;11;6;6;2;0;8;33
may-11;Société;114;87;61;32;38;99;431
may-11;Sport;59;72;41;13;8;41;234
june-11;Catastrophes;22;26;28;12;0;23;111
june-11;Culture-loisirs;43;30;20;5;70;42;210
june-11;Economie;53;51;42;16;26;28;216
june-11;Education;39;29;18;15;0;21;122
june-11;Environnement;38;24;12;7;11;16;108
june-11;Faits divers;43;37;30;18;0;37;165
june-11;Histoire-hommages;15;10;2;0;8;4;39
june-11;International;74;118;77;62;124;44;499
june-11;Justice;62;65;45;40;11;55;278
june-11;Politique France;50;74;48;24;5;37;238
june-11;Santé;48;38;31;11;7;42;177
june-11;Sciences et techniques;10;9;6;4;4;6;39
june-11;Société;90;88;53;53;29;60;373
june-11;Sport;47;39;22;4;3;26;141
july-11;Catastrophes;32;32;20;15;11;21;131
july-11;Culture-loisirs;68;39;28;11;27;44;217
july-11;Economie;67;65;49;30;23;28;262
july-11;Education;12;14;8;4;0;5;43
july-11;Environnement;23;29;21;12;5;16;106
july-11;Faits divers;33;21;18;13;1;35;121
july-11;Histoire-hommages;16;12;9;7;4;5;53
july-11;International;75;105;69;80;118;48;495
july-11;Justice;53;54;29;30;8;33;207
july-11;Politique France;38;60;43;29;5;26;201
july-11;Santé;14;11;10;5;0;8;48
july-11;Sciences et techniques;18;9;9;4;2;14;56
july-11;Société;91;84;68;49;22;92;406
july-11;Sport;67;67;43;30;3;45;255
august-11;Catastrophes;44;50;36;24;15;27;196
august-11;Culture-loisirs;77;50;26;7;44;45;249
august-11;Economie;129;136;79;52;42;63;501
august-11;Education;16;22;15;6;0;10;69
august-11;Environnement;48;32;23;6;9;21;139
august-11;Faits divers;49;54;57;29;1;69;259
august-11;Histoire-hommages;9;8;5;9;6;2;39
august-11;International;77;111;68;83;158;37;534
august-11;Justice;44;46;36;30;9;33;198
august-11;Politique France;36;28;38;17;2;20;141
august-11;Santé;18;17;18;14;3;20;90
august-11;Sciences et techniques;14;6;3;3;0;4;30
august-11;Société;137;124;92;79;38;125;595
august-11;Sport;81;57;41;24;1;31;235
september-11;Catastrophes;17;19;13;5;1;16;71
september-11;Culture-loisirs;49;39;27;14;58;46;233
september-11;Economie;78;92;39;51;41;37;338
september-11;Education;18;25;15;10;4;21;93
september-11;Environnement;23;17;5;6;6;11;68
september-11;Faits divers;28;29;32;10;0;42;141
september-11;Histoire-hommages;9;13;9;3;4;8;46
september-11;International;85;81;44;73;142;35;460
september-11;Justice;61;73;63;59;15;64;335
september-11;Politique France;49;55;53;34;7;35;233
september-11;Santé;23;14;22;11;5;9;84
september-11;Sciences et techniques;13;8;10;9;2;12;54
september-11;Société;71;71;43;53;20;56;314
september-11;Sport;61;53;29;21;0;33;197
october-11;Catastrophes;26;26;16;15;8;18;109
october-11;Culture-loisirs;53;31;23;15;62;49;233
october-11;Economie;63;65;37;40;37;41;283
october-11;Education;12;12;2;7;0;5;38
october-11;Environnement;23;13;10;10;3;10;69
october-11;Faits divers;30;34;21;14;3;37;139
october-11;Histoire-hommages;11;16;4;7;12;4;54
october-11;International;69;75;59;85;133;50;471
october-11;Justice;45;36;41;28;4;39;193
october-11;Politique France;91;140;74;43;10;50;408
october-11;Santé;20;10;11;2;3;17;63
october-11;Sciences et techniques;7;8;7;0;1;3;26
october-11;Société;86;74;57;73;33;78;401
october-11;Sport;75;63;33;18;0;36;225
november-11;Catastrophes;69;50;47;21;3;45;235
november-11;Culture-loisirs;58;50;29;10;80;64;291
november-11;Economie;95;105;71;43;33;58;405
november-11;Education;17;15;6;5;2;9;54
november-11;Environnement;32;39;16;11;11;10;119
november-11;Faits divers;60;51;46;19;14;57;247
november-11;Histoire-hommages;17;17;16;8;7;12;77
november-11;International;100;111;83;116;176;65;651
november-11;Justice;48;42;27;49;11;44;221
november-11;Politique France;43;66;34;28;4;26;201
november-11;Santé;22;21;20;11;1;20;95
november-11;Sciences et techniques;20;18;9;12;8;11;78
november-11;Société;121;102;78;71;48;111;531
november-11;Sport;44;33;16;11;0;24;128
december-11;Catastrophes;38;26;28;10;2;16;120
december-11;Culture-loisirs;68;42;33;8;47;42;240
december-11;Economie;67;73;48;37;18;32;275
december-11;Education;8;8;4;7;1;2;30
december-11;Environnement;20;20;16;8;8;11;83
december-11;Faits divers;35;37;33;17;1;37;160
december-11;Histoire-hommages;13;17;8;9;11;6;64
december-11;International;61;114;40;67;133;32;447
december-11;Justice;37;28;31;34;14;33;177
december-11;Politique France;26;30;27;22;7;19;131
december-11;Santé;23;33;18;11;2;22;109
december-11;Sciences et techniques;12;8;10;7;3;8;48
december-11;Société;149;125;90;80;25;122;591
december-11;Sport;38;27;11;14;1;23;114
january-12;Catastrophes;111;80;45;18;2;45;301
january-12;Culture-loisirs;73;59;38;16;33;60;279
january-12;Economie;99;111;78;64;31;56;439
january-12;Education;14;16;10;6;2;8;56
january-12;Environnement;26;50;15;16;5;23;135
january-12;Faits divers;29;27;33;12;3;49;153
january-12;Histoire-hommages;12;8;9;4;10;8;51
january-12;International;72;97;53;93;178;44;537
january-12;Justice;28;23;28;19;14;25;137
january-12;Politique France;79;103;82;52;13;46;375
january-12;Santé;32;29;17;11;3;19;111
january-12;Sciences et techniques;13;9;6;6;3;7;44
january-12;Société;111;105;74;61;38;78;467
january-12;Sport;47;44;24;7;0;26;148
february-12;Catastrophes;63;59;40;11;0;50;223
february-12;Culture-loisirs;50;36;29;17;36;52;220
february-12;Economie;65;68;52;30;26;35;276
february-12;Education;9;13;7;2;3;5;39
february-12;Environnement;57;47;22;7;6;19;158
february-12;Faits divers;25;19;17;5;5;31;102
february-12;Histoire-hommages;10;12;6;4;11;14;57
february-12;International;53;74;40;79;132;36;414
february-12;Justice;26;23;28;32;7;34;150
february-12;Politique France;87;107;82;51;7;69;403
february-12;Santé;22;15;15;10;1;13;76
february-12;Sciences et techniques;5;9;2;4;1;8;29
february-12;Société;106;98;62;66;35;73;440
february-12;Sport;37;35;17;9;0;18;116
march-12;Catastrophes;58;52;34;16;2;32;194
march-12;Culture-loisirs;36;22;17;12;20;34;141
march-12;Economie;38;27;27;21;20;16;149
march-12;Education;11;15;6;2;0;7;41
march-12;Environnement;35;27;23;8;12;11;116
march-12;Faits divers;25;29;15;18;5;28;120
march-12;Histoire-hommages;19;20;9;5;8;12;73
march-12;International;40;51;26;68;110;18;313
march-12;Justice;26;29;15;17;10;19;116
march-12;Politique France;195;198;155;89;35;147;819
march-12;Santé;17;19;13;10;5;21;85
march-12;Sciences et techniques;8;7;8;3;1;5;32
march-12;Société;80;101;40;52;29;53;355
march-12;Sport;36;41;19;6;0;20;122
april-12;Catastrophes;21;25;17;15;4;16;98
april-12;Culture-loisirs;37;36;14;14;18;52;171
april-12;Economie;68;72;35;28;17;29;249
april-12;Education;9;7;5;1;0;6;28
april-12;Environnement;27;25;15;9;4;11;91
april-12;Faits divers;61;42;48;23;5;38;217
april-12;Histoire-hommages;13;10;9;4;5;5;46
april-12;International;59;70;33;63;127;25;377
april-12;Justice;31;35;25;25;12;22;150
april-12;Politique France;120;129;109;52;39;142;591
april-12;Santé;14;18;8;4;1;12;57
april-12;Sciences et techniques;15;13;7;5;4;11;55
april-12;Société;72;85;55;53;31;72;368
april-12;Sport;28;23;22;16;2;22;113
may-12;Catastrophes;42;37;29;12;3;18;141
may-12;Culture-loisirs;63;33;30;19;38;61;244
may-12;Economie;62;69;49;33;33;33;279
may-12;Education;16;18;6;5;1;6;52
may-12;Environnement;22;20;9;8;7;9;75
may-12;Faits divers;40;29;34;12;2;37;154
may-12;Histoire-hommages;13;18;10;7;3;12;63
may-12;International;103;144;69;107;169;58;650
may-12;Justice;28;28;25;33;15;32;161
may-12;Politique France;174;221;133;62;27;105;722
may-12;Santé;27;15;12;8;2;22;86
may-12;Sciences et techniques;7;10;8;5;2;8;40
may-12;Société;104;94;61;58;30;104;451
may-12;Sport;80;63;40;20;3;29;235
june-12;Catastrophes;15;13;10;12;3;15;68
june-12;Culture-loisirs;47;20;22;12;31;37;169
june-12;Economie;58;70;40;34;39;16;257
june-12;Education;26;33;14;7;0;16;96
june-12;Environnement;19;15;11;7;9;4;65
june-12;Faits divers;43;47;41;23;0;42;196
june-12;Histoire-hommages;22;14;9;4;3;15;67
june-12;International;55;80;37;46;93;27;338
june-12;Justice;30;13;25;23;15;12;118
june-12;Politique France;84;109;89;35;21;83;421
june-12;Santé;11;19;11;3;1;14;59
june-12;Sciences et techniques;9;9;8;2;2;4;34
june-12;Société;78;97;55;42;31;53;356
june-12;Sport;86;53;29;23;3;73;267
july-12;Catastrophes;45;62;39;16;7;44;213
july-12;Culture-loisirs;79;35;32;9;42;63;260
july-12;Economie;109;127;72;42;38;67;455
july-12;Education;11;16;7;5;0;9;48
july-12;Environnement;37;36;17;9;9;14;122
july-12;Faits divers;39;36;42;13;2;54;186
july-12;Histoire-hommages;13;22;13;7;14;11;80
july-12;International;46;96;45;41;129;26;383
july-12;Justice;20;26;19;18;14;25;122
july-12;Politique France;55;55;25;17;6;27;185
july-12;Santé;19;21;12;8;2;12;74
july-12;Sciences et techniques;20;14;5;6;6;7;58
july-12;Société;94;109;77;51;31;85;447
july-12;Sport;156;172;105;46;10;75;564
august-12;Catastrophes;36;47;38;16;8;26;171
august-12;Culture-loisirs;52;26;17;8;22;36;161
august-12;Economie;62;69;39;34;28;34;266
august-12;Education;18;14;5;4;1;9;51
august-12;Environnement;50;27;20;10;9;19;135
august-12;Faits divers;22;33;19;14;4;24;116
august-12;Histoire-hommages;10;17;6;7;6;5;51
august-12;International;44;85;42;57;109;40;377
august-12;Justice;19;19;20;20;17;17;112
august-12;Politique France;37;32;37;18;6;29;159
august-12;Santé;22;31;21;11;2;20;107
august-12;Sciences et techniques;27;16;12;5;5;12;77
august-12;Société;99;82;62;45;30;74;392
august-12;Sport;108;179;73;29;3;43;435
september-12;Catastrophes;18;19;18;8;3;16;82
september-12;Culture-loisirs;55;35;20;15;27;55;207
september-12;Economie;63;106;68;32;37;43;349
september-12;Education;26;26;27;11;0;13;103
september-12;Environnement;15;14;14;10;5;7;65
september-12;Faits divers;60;47;38;6;2;49;202
september-12;Histoire-hommages;15;10;8;3;7;4;47
september-12;International;52;67;36;49;98;32;334
september-12;Justice;30;32;29;28;10;31;160
september-12;Politique France;34;39;38;23;5;29;168
september-12;Santé;14;27;18;9;2;19;89
september-12;Sciences et techniques;13;7;6;3;1;5;35
september-12;Société;120;138;89;68;59;109;583
september-12;Sport;44;36;14;9;0;27;130
october-12;Catastrophes;59;70;45;20;5;60;259
october-12;Culture-loisirs;64;43;31;19;39;58;254
october-12;Economie;87;119;60;31;37;32;366
october-12;Education;16;23;15;4;4;8;70
october-12;Environnement;25;25;24;7;6;14;101
october-12;Faits divers;41;53;40;25;1;60;220
october-12;Histoire-hommages;15;10;8;3;5;4;45
october-12;International;55;83;45;81;147;32;443
october-12;Justice;57;64;54;58;19;46;298
october-12;Politique France;49;68;50;24;11;35;237
october-12;Santé;31;26;22;9;4;22;114
october-12;Sciences et techniques;15;12;8;2;2;9;48
october-12;Société;133;139;87;72;43;119;593
october-12;Sport;61;35;23;17;1;29;166
november-12;Catastrophes;17;28;15;4;3;19;86
november-12;Culture-loisirs;46;27;24;5;26;47;175
november-12;Economie;69;94;49;27;23;29;291
november-12;Education;5;5;5;5;0;3;23
november-12;Environnement;23;27;18;9;9;11;97
november-12;Faits divers;38;44;41;13;2;52;190
november-12;Histoire-hommages;11;13;7;7;5;7;50
november-12;International;97;115;54;81;118;56;521
november-12;Justice;27;32;27;22;10;28;146
november-12;Politique France;56;96;63;32;13;45;305
november-12;Santé;11;22;17;10;2;13;75
november-12;Sciences et techniques;8;5;4;6;0;5;28
november-12;Société;111;136;72;69;35;92;515
november-12;Sport;46;32;27;12;0;26;143
december-12;Catastrophes;27;36;19;12;4;18;116
december-12;Culture-loisirs;63;50;37;5;23;51;229
december-12;Economie;64;93;52;39;19;41;308
december-12;Education;8;14;10;7;1;9;49
december-12;Environnement;23;25;18;9;14;12;101
december-12;Faits divers;49;48;36;13;7;53;206
december-12;Histoire-hommages;7;6;4;3;7;5;32
december-12;International;45;83;50;49;119;34;380
december-12;Justice;21;25;23;22;14;20;125
december-12;Politique France;31;43;22;19;3;18;136
december-12;Santé;35;25;26;9;2;20;117
december-12;Sciences et techniques;13;12;6;7;1;9;48
december-12;Société;132;171;101;73;45;116;638
december-12;Sport;33;17;7;16;0;9;82
january-13;Catastrophes;52;76;25;12;2;48;215
january-13;Culture-loisirs;76;67;24;12;23;58;260
january-13;Economie;68;86;61;45;34;42;336
january-13;Education;13;9;10;3;3;13;51
january-13;Environnement;28;30;36;9;5;14;122
january-13;Faits divers;32;42;30;13;8;54;179
january-13;Histoire-hommages;10;10;4;7;15;5;51
january-13;International;143;174;96;75;139;82;709
january-13;Justice;28;44;33;28;14;46;193
january-13;Politique France;35;33;23;10;5;19;125
january-13;Santé;17;29;20;13;5;20;104
january-13;Sciences et techniques;9;11;8;7;3;8;46
january-13;Société;154;166;107;81;56;110;674
january-13;Sport;56;40;27;18;3;31;175
february-13;Catastrophes;30;31;22;9;0;16;108
february-13;Culture-loisirs;40;46;26;15;34;41;202
february-13;Economie;64;70;49;38;26;46;293
february-13;Education;16;12;13;3;3;21;68
february-13;Environnement;27;22;12;9;4;5;79
february-13;Faits divers;32;33;25;21;3;52;166
february-13;Histoire-hommages;9;9;3;4;6;2;33
february-13;International;96;111;57;66;119;63;512
february-13;Justice;16;11;17;19;8;24;95
february-13;Politique France;16;29;13;8;1;15;82
february-13;Santé;18;21;16;5;3;14;77
february-13;Sciences et techniques;14;11;3;11;2;11;52
february-13;Société;139;193;118;77;50;128;705
february-13;Sport;43;34;25;17;1;23;143
march-13;Catastrophes;42;60;40;9;0;37;188
march-13;Culture-loisirs;35;24;23;14;21;51;168
march-13;Economie;51;81;43;35;34;33;277
march-13;Education;9;9;9;3;0;8;38
march-13;Environnement;25;27;13;10;10;15;100
march-13;Faits divers;22;31;14;10;5;17;99
march-13;Histoire-hommages;13;21;12;10;10;9;75
march-13;International;45;75;30;77;105;31;363
march-13;Justice;32;38;35;19;13;44;181
march-13;Politique France;42;48;39;20;3;34;186
march-13;Santé;12;15;15;15;2;17;76
march-13;Sciences et techniques;16;8;7;4;1;8;44
march-13;Société;164;156;96;78;50;114;658
march-13;Sport;38;25;11;14;0;14;102
april-13;Catastrophes;27;31;24;14;5;21;122
april-13;Culture-loisirs;79;35;24;13;29;48;228
april-13;Economie;91;82;48;44;32;38;335
april-13;Education;14;18;13;3;0;8;56
april-13;Environnement;37;38;22;10;6;11;124
april-13;Faits divers;46;52;46;32;3;56;235
april-13;Histoire-hommages;13;11;9;10;7;6;56
april-13;International;88;128;59;95;134;75;579
april-13;Justice;29;34;37;32;20;36;188
april-13;Politique France;96;127;77;42;18;66;426
april-13;Santé;29;25;24;15;8;18;119
april-13;Sciences et techniques;10;13;9;6;3;8;49
april-13;Société;118;140;69;59;35;86;507
april-13;Sport;38;33;30;21;0;18;140
may-13;Catastrophes;54;62;40;16;2;36;210
may-13;Culture-loisirs;56;34;39;13;29;53;224
may-13;Economie;49;71;38;37;13;25;233
may-13;Education;16;23;8;3;3;10;63
may-13;Environnement;24;34;27;8;9;13;115
may-13;Faits divers;34;63;31;30;2;52;212
may-13;Histoire-hommages;13;15;8;4;10;8;58
may-13;International;26;60;22;36;103;33;280
may-13;Justice;32;42;31;37;16;29;187
may-13;Politique France;55;75;36;29;16;39;250
may-13;Santé;28;33;26;17;3;24;131
may-13;Sciences et techniques;12;16;7;6;2;4;47
may-13;Société;75;90;69;41;43;74;392
may-13;Sport;63;48;34;26;0;23;194
june-13;Catastrophes;60;62;39;21;5;42;229
june-13;Culture-loisirs;65;32;22;14;30;52;215
june-13;Economie;41;84;35;26;17;36;239
june-13;Education;26;22;18;6;0;15;87
june-13;Environnement;20;39;12;8;3;19;101
june-13;Faits divers;16;17;22;9;1;28;93
june-13;Histoire-hommages;13;21;12;9;5;8;68
june-13;International;55;67;44;63;115;43;387
june-13;Justice;27;47;35;48;25;32;214
june-13;Politique France;52;55;44;33;12;44;240
june-13;Santé;18;34;18;14;2;24;110
june-13;Sciences et techniques;8;7;2;8;1;7;33
june-13;Société;79;119;79;56;26;73;432
june-13;Sport;46;47;31;24;0;36;184
july-13;Catastrophes;96;141;74;50;10;83;454
july-13;Culture-loisirs;74;53;23;7;33;53;243
july-13;Economie;63;67;43;25;16;38;252
july-13;Education;10;12;7;2;0;6;37
july-13;Environnement;49;59;27;13;3;22;173
july-13;Faits divers;28;35;24;25;2;38;152
july-13;Histoire-hommages;9;8;8;1;1;5;32
july-13;International;54;75;50;62;160;47;448
july-13;Justice;27;44;25;41;44;23;204
july-13;Politique France;51;81;48;32;7;41;260
july-13;Santé;19;27;21;7;1;14;89
july-13;Sciences et techniques;11;17;8;4;1;11;52
july-13;Société;148;192;101;90;32;132;695
july-13;Sport;57;66;53;50;0;40;266
august-13;Catastrophes;34;56;38;18;3;24;173
august-13;Culture-loisirs;70;50;25;12;26;39;222
august-13;Economie;62;91;52;19;15;31;270
august-13;Education;19;8;11;5;0;12;55
august-13;Environnement;26;31;19;11;11;7;105
august-13;Faits divers;57;63;49;42;5;53;269
august-13;Histoire-hommages;8;4;5;5;6;2;30
august-13;International;59;102;47;63;110;53;434
august-13;Justice;17;27;20;21;19;23;127
august-13;Politique France;23;29;23;12;3;25;115
august-13;Santé;13;6;17;5;7;10;58
august-13;Sciences et techniques;17;19;10;4;1;10;61
august-13;Société;96;142;58;63;19;88;466
august-13;Sport;44;52;24;21;1;21;163
september-13;Catastrophes;16;30;17;12;3;19;97
september-13;Culture-loisirs;56;35;32;7;27;43;200
september-13;Economie;53;74;42;34;16;27;246
september-13;Education;21;30;10;8;2;19;90
september-13;Environnement;23;39;22;15;13;15;127
september-13;Faits divers;47;61;41;17;1;56;223
september-13;Histoire-hommages;5;13;6;5;4;4;37
september-13;International;95;120;76;53;120;65;529
september-13;Justice;14;17;19;15;13;18;96
september-13;Politique France;30;45;32;15;6;27;155
september-13;Santé;18;17;16;9;3;9;72
september-13;Sciences et techniques;15;7;4;6;1;5;38
september-13;Société;75;92;64;41;22;77;371
september-13;Sport;44;39;14;15;1;27;140
october-13;Catastrophes;40;63;42;15;18;33;211
october-13;Culture-loisirs;71;49;26;14;34;65;259
october-13;Economie;88;117;87;46;23;57;418
october-13;Education;19;17;10;1;1;4;52
october-13;Environnement;20;36;15;15;7;14;107
october-13;Faits divers;31;37;34;13;1;44;160
october-13;Histoire-hommages;11;15;14;4;13;10;67
october-13;International;71;97;38;63;125;43;437
october-13;Justice;30;31;34;18;14;28;155
october-13;Politique France;63;89;50;34;15;55;306
october-13;Santé;32;24;25;12;5;27;125
october-13;Sciences et techniques;11;21;7;11;5;11;66
october-13;Société;101;157;84;70;39;128;579
october-13;Sport;52;40;31;15;1;22;161
november-13;Catastrophes;48;57;34;17;11;22;189
november-13;Culture-loisirs;47;41;13;16;25;45;187
november-13;Economie;92;109;71;41;20;66;399
november-13;Education;7;6;8;5;3;7;36
november-13;Environnement;10;26;21;6;13;14;90
november-13;Faits divers;33;37;41;15;1;46;173
november-13;Histoire-hommages;27;31;23;10;16;17;124
november-13;International;52;78;40;61;102;46;379
november-13;Justice;12;15;25;19;7;32;110
november-13;Politique France;28;28;29;26;5;20;136
november-13;Santé;11;18;16;3;0;11;59
november-13;Sciences et techniques;6;15;8;5;4;8;46
november-13;Société;74;93;66;54;32;60;379
november-13;Sport;52;32;27;24;2;26;163
december-13;Catastrophes;58;60;51;33;0;40;242
december-13;Culture-loisirs;71;69;26;12;33;59;270
december-13;Economie;86;113;66;31;16;41;353
december-13;Education;10;12;7;4;2;8;43
december-13;Environnement;23;31;23;14;3;15;109
december-13;Faits divers;43;40;38;19;3;48;191
december-13;Histoire-hommages;46;54;37;26;15;33;211
december-13;International;79;101;57;87;141;53;518
december-13;Justice;18;16;24;14;16;26;114
december-13;Politique France;28;36;31;29;5;21;150
december-13;Santé;17;20;19;7;3;22;88
december-13;Sciences et techniques;9;14;13;7;6;11;60
december-13;Société;117;158;114;71;44;113;617
december-13;Sport;33;27;22;11;0;20;113
january-14;Catastrophes;61;71;47;13;2;49;243
january-14;Culture-loisirs;50;40;16;13;22;40;181
january-14;Economie;46;61;34;26;14;29;210
january-14;Education;18;13;12;3;3;10;59
january-14;Environnement;29;29;35;14;10;12;129
january-14;Faits divers;20;20;21;13;1;34;109
january-14;Histoire-hommages;9;13;13;5;12;9;61
january-14;International;46;72;35;55;124;36;368
january-14;Justice;32;34;33;21;12;41;173
january-14;Politique France;31;35;31;14;5;24;140
january-14;Santé;28;25;25;10;1;22;111
january-14;Sciences et techniques;13;7;12;12;2;6;52
january-14;Société;114;146;78;63;22;110;533
january-14;Sport;44;32;24;18;2;23;143
february-14;Catastrophes;58;54;50;15;2;57;236
february-14;Culture-loisirs;45;41;16;14;28;41;185
february-14;Economie;70;76;46;24;14;38;268
february-14;Education;13;7;1;0;2;5;28
february-14;Environnement;47;64;28;9;5;24;177
february-14;Faits divers;17;28;18;14;3;44;124
february-14;Histoire-hommages;6;10;4;5;9;3;37
february-14;International;64;99;47;64;115;60;449
february-14;Justice;20;19;22;23;15;29;128
february-14;Politique France;22;20;15;13;9;11;90
february-14;Santé;15;16;17;7;2;10;67
february-14;Sciences et techniques;12;11;2;5;1;7;38
february-14;Société;91;90;56;49;26;103;415
february-14;Sport;73;117;33;18;5;39;285
march-14;Catastrophes;51;53;29;16;10;34;193
march-14;Culture-loisirs;37;32;23;17;28;44;181
march-14;Economie;39;60;34;17;10;24;184
march-14;Education;7;9;4;1;5;7;33
march-14;Environnement;47;55;37;16;6;27;188
march-14;Faits divers;11;11;10;12;0;28;72
march-14;Histoire-hommages;11;12;12;5;10;7;57
march-14;International;87;111;46;60;113;41;458
march-14;Justice;45;50;39;45;20;49;248
march-14;Politique France;55;77;62;26;15;60;295
march-14;Santé;14;21;16;9;3;14;77
march-14;Sciences et techniques;11;12;5;6;3;6;43
march-14;Société;64;69;43;40;18;66;300
march-14;Sport;32;35;20;18;0;17;122
april-14;Catastrophes;18;36;16;20;9;21;120
april-14;Culture-loisirs;53;50;20;21;35;42;221
april-14;Economie;67;79;58;26;19;42;291
april-14;Education;11;8;8;0;2;9;38
april-14;Environnement;23;27;17;4;4;4;79
april-14;Faits divers;24;33;34;14;1;54;160
april-14;Histoire-hommages;21;22;17;8;11;10;89
april-14;International;74;114;63;78;144;77;550
april-14;Justice;24;30;35;22;10;43;164
april-14;Politique France;112;146;94;54;24;73;503
april-14;Santé;19;22;20;1;6;22;90
april-14;Sciences et techniques;15;16;12;7;3;13;66
april-14;Société;99;130;81;47;35;104;496
april-14;Sport;46;40;31;39;0;24;180
may-14;Catastrophes;25;32;22;10;10;31;130
may-14;Culture-loisirs;60;33;29;21;23;46;212
may-14;Economie;42;82;43;31;7;32;237
may-14;Education;16;9;6;1;0;6;38
may-14;Environnement;20;23;9;5;2;5;64
may-14;Faits divers;23;29;30;7;0;43;132
may-14;Histoire-hommages;18;24;19;6;9;6;82
may-14;International;114;155;79;77;138;88;651
may-14;Justice;28;36;36;21;7;34;162
may-14;Politique France;23;38;34;15;8;22;140
may-14;Santé;15;9;16;7;2;20;69
may-14;Sciences et techniques;8;17;2;4;1;11;43
may-14;Société;58;87;64;30;25;75;339
may-14;Sport;52;47;27;27;0;26;179
june-14;Catastrophes;10;24;10;8;3;24;79
june-14;Culture-loisirs;23;40;18;18;30;43;172
june-14;Economie;30;57;27;14;13;24;165
june-14;Education;21;13;17;6;3;19;79
june-14;Environnement;12;24;15;3;3;9;66
june-14;Faits divers;16;19;18;14;1;37;105
june-14;Histoire-hommages;45;57;39;13;6;32;192
june-14;International;48;89;35;62;124;47;405
june-14;Justice;28;41;33;34;17;39;192
june-14;Politique France;32;43;15;12;7;18;127
june-14;Santé;6;5;8;2;2;11;34
june-14;Sciences et techniques;3;8;4;5;0;7;27
june-14;Société;98;126;83;48;21;95;471
june-14;Sport;150;93;57;46;2;77;425
july-14;Catastrophes;131;140;87;41;26;88;513
july-14;Culture-loisirs;49;40;31;27;35;43;225
july-14;Economie;51;65;43;15;12;36;222
july-14;Education;9;10;10;4;2;7;42
july-14;Environnement;19;38;20;9;4;14;104
july-14;Faits divers;20;29;24;15;1;28;117
july-14;Histoire-hommages;17;19;12;8;9;4;69
july-14;International;68;115;43;83;143;60;512
july-14;Justice;26;45;33;25;13;39;181
july-14;Politique France;37;47;38;23;10;27;182
july-14;Santé;9;22;13;12;6;8;70
july-14;Sciences et techniques;5;15;7;9;0;2;38
july-14;Société;95;123;91;47;30;97;483
july-14;Sport;152;112;69;58;9;87;487
august-14;Catastrophes;32;45;35;14;5;25;156
august-14;Culture-loisirs;62;37;12;18;26;42;197
august-14;Economie;66;68;43;18;12;34;241
august-14;Education;17;8;4;2;0;11;42
august-14;Environnement;27;23;11;5;3;10;79
august-14;Faits divers;16;31;29;8;2;30;116
august-14;Histoire-hommages;29;30;26;14;13;20;132
august-14;International;75;113;54;82;120;62;506
august-14;Justice;16;26;16;13;4;15;90
august-14;Politique France;48;55;45;24;10;30;212
august-14;Santé;11;27;13;18;13;7;89
august-14;Sciences et techniques;12;11;5;9;2;10;49
august-14;Société;51;99;76;37;29;72;364
august-14;Sport;47;74;35;29;0;33;218
september-14;Catastrophes;40;54;40;7;6;47;194
september-14;Culture-loisirs;63;43;24;20;30;56;236
september-14;Economie;66;85;60;30;6;43;290
september-14;Education;23;20;20;5;2;32;102
september-14;Environnement;24;32;19;7;6;7;95
september-14;Faits divers;21;30;26;6;1;44;128
september-14;Histoire-hommages;10;9;8;3;5;0;35
september-14;International;132;163;67;86;177;72;697
september-14;Justice;27;29;27;16;6;36;141
september-14;Politique France;74;103;76;32;14;56;355
september-14;Santé;18;30;22;19;12;26;127
september-14;Sciences et techniques;7;16;8;6;1;9;47
september-14;Société;109;134;92;42;22;85;484
september-14;Sport;45;40;23;42;0;16;166
october-14;Catastrophes;43;51;31;12;3;34;174
october-14;Culture-loisirs;45;30;28;28;26;33;190
october-14;Economie;67;81;63;17;11;35;274
october-14;Education;10;5;2;2;1;2;22
october-14;Environnement;47;55;35;13;2;32;184
october-14;Faits divers;17;22;23;10;2;31;105
october-14;Histoire-hommages;4;9;5;2;5;2;27
october-14;International;54;99;47;58;121;47;426
october-14;Justice;24;26;25;16;8;32;131
october-14;Politique France;37;37;27;22;8;15;146
october-14;Santé;27;57;49;17;19;49;218
october-14;Sciences et techniques;10;10;10;1;3;8;42
october-14;Société;57;102;98;29;27;70;383
october-14;Sport;48;33;25;32;0;17;155
november-14;Catastrophes;40;50;42;6;3;36;177
november-14;Culture-loisirs;48;38;32;20;21;52;211
november-14;Economie;50;69;38;19;15;23;214
november-14;Education;9;9;4;1;0;7;30
november-14;Environnement;56;32;28;11;13;20;160
november-14;Faits divers;21;23;20;7;0;43;114
november-14;Histoire-hommages;25;22;20;5;10;8;90
november-14;International;58;84;44;48;105;42;381
november-14;Justice;32;39;31;19;16;31;168
november-14;Politique France;37;57;35;29;4;22;184
november-14;Santé;16;14;18;4;7;20;79
november-14;Sciences et techniques;17;22;8;7;5;12;71
november-14;Société;84;86;59;43;33;86;391
november-14;Sport;38;39;26;41;0;30;174
december-14;Catastrophes;74;88;57;16;16;56;307
december-14;Culture-loisirs;80;55;44;28;25;74;306
december-14;Economie;79;86;61;22;24;44;316
december-14;Education;11;8;6;5;1;5;36
december-14;Environnement;33;43;24;10;12;17;139
december-14;Faits divers;25;31;29;17;10;47;159
december-14;Histoire-hommages;6;20;11;2;6;4;49
december-14;International;60;91;35;51;128;37;402
december-14;Justice;13;16;11;11;14;32;97
december-14;Politique France;49;50;39;23;7;20;188
december-14;Santé;25;30;26;7;10;20;118
december-14;Sciences et techniques;11;10;6;7;3;6;43
december-14;Société;141;182;118;65;46;130;682
december-14;Sport;31;27;17;43;0;16;134
january-15;Catastrophes;29;27;35;7;5;34;137
january-15;Culture-loisirs;41;34;18;26;25;47;191
january-15;Economie;39;48;23;13;8;16;147
january-15;Education;8;10;6;2;3;8;37
january-15;Environnement;21;15;8;4;1;8;57
january-15;Faits divers;6;6;10;4;0;6;32
january-15;Histoire-hommages;16;14;13;10;11;13;77
january-15;International;65;98;51;55;108;44;421
january-15;Justice;13;8;11;13;6;20;71
january-15;Politique France;223;262;144;79;58;191;957
january-15;Santé;18;17;13;5;2;20;75
january-15;Sciences et techniques;10;4;3;3;0;5;25
january-15;Société;72;91;67;27;32;79;368
january-15;Sport;25;23;13;26;0;10;97
february-15;Catastrophes;48;38;37;4;3;26;156
february-15;Culture-loisirs;54;37;23;27;26;40;207
february-15;Economie;84;107;66;29;40;51;377
february-15;Education;16;7;6;2;1;8;40
february-15;Environnement;32;27;26;6;2;15;108
february-15;Faits divers;22;28;20;9;3;25;107
february-15;Histoire-hommages;7;16;9;2;6;4;44
february-15;International;65;92;60;52;114;51;434
february-15;Justice;22;26;17;23;11;29;128
february-15;Politique France;50;62;33;20;10;45;220
february-15;Santé;15;12;15;3;2;17;64
february-15;Sciences et techniques;8;8;5;5;0;5;31
february-15;Société;50;76;54;41;20;68;309
february-15;Sport;41;41;25;27;1;27;162
march-15;Catastrophes;97;133;72;27;15;74;418
march-15;Culture-loisirs;45;30;25;27;23;42;192
march-15;Economie;51;62;35;21;17;18;204
march-15;Education;15;12;7;3;0;9;46
march-15;Environnement;41;41;43;9;10;30;174
march-15;Faits divers;53;59;39;23;8;57;239
march-15;Histoire-hommages;6;9;6;1;9;1;32
march-15;International;64;99;38;42;160;55;458
march-15;Justice;11;21;18;18;13;27;108
march-15;Politique France;102;138;58;34;15;91;438
march-15;Santé;29;25;17;7;2;23;103
march-15;Sciences et techniques;14;25;12;3;4;17;75
march-15;Société;91;83;68;39;40;94;415
march-15;Sport;36;34;34;41;1;27;173
april-15;Catastrophes;69;64;53;25;12;57;280
april-15;Culture-loisirs;43;36;36;34;26;39;214
april-15;Economie;44;80;50;15;17;40;246
april-15;Education;13;10;4;0;3;4;34
april-15;Environnement;17;17;7;6;2;11;60
april-15;Faits divers;48;51;45;21;2;54;221
april-15;Histoire-hommages;29;26;30;11;24;19;139
april-15;International;32;55;19;29;88;35;258
april-15;Justice;21;18;9;7;13;33;101
april-15;Politique France;48;56;48;30;17;34;233
april-15;Santé;25;7;15;6;2;17;72
april-15;Sciences et techniques;11;10;7;7;5;9;49
april-15;Société;73;110;51;32;29;89;384
april-15;Sport;33;22;20;34;0;16;125
may-15;Catastrophes;27;23;21;5;8;28;112
may-15;Culture-loisirs;50;39;29;23;26;58;225
may-15;Economie;49;89;47;12;5;25;227
may-15;Education;24;22;19;4;4;20;93
may-15;Environnement;18;26;17;4;9;4;78
may-15;Faits divers;16;15;24;4;1;18;78
may-15;Histoire-hommages;21;24;17;10;11;13;96
may-15;International;51;98;35;52;128;48;412
may-15;Justice;25;15;18;15;12;29;114
may-15;Politique France;33;34;32;18;6;25;148
may-15;Santé;20;20;12;4;2;26;84
may-15;Sciences et techniques;16;6;6;3;0;12;43
may-15;Société;98;97;54;21;27;81;378
may-15;Sport;47;28;25;40;4;28;172
june-15;Catastrophes;32;26;13;10;3;34;118
june-15;Culture-loisirs;51;40;24;29;34;60;238
june-15;Economie;77;142;70;42;47;57;435
june-15;Education;21;23;8;2;0;14;68
june-15;Environnement;39;31;27;4;14;22;137
june-15;Faits divers;25;18;27;11;6;42;129
june-15;Histoire-hommages;23;14;13;7;6;14;77
june-15;International;89;117;55;69;124;64;518
june-15;Justice;27;23;24;25;17;33;149
june-15;Politique France;79;84;68;49;11;66;357
june-15;Santé;23;8;16;8;5;32;92
june-15;Sciences et techniques;10;15;11;4;6;16;62
june-15;Société;89;106;83;46;29;79;432
june-15;Sport;59;46;38;54;4;43;244
july-15;Catastrophes;32;55;44;15;4;34;184
july-15;Culture-loisirs;57;22;30;36;28;50;223
july-15;Economie;126;154;90;56;56;78;560
july-15;Education;5;5;3;3;0;9;25
july-15;Environnement;28;32;25;8;2;14;109
july-15;Faits divers;8;13;10;7;9;19;66
july-15;Histoire-hommages;4;8;7;4;4;4;31
july-15;International;50;89;42;42;103;41;367
july-15;Justice;4;17;8;8;6;21;64
july-15;Politique France;43;31;30;23;5;26;158
july-15;Santé;11;5;10;9;2;15;52
july-15;Sciences et techniques;20;12;7;3;3;13;58
july-15;Société;79;90;50;31;18;76;344
july-15;Sport;51;54;47;53;4;41;250
august-15;Catastrophes;31;62;43;11;18;51;216
august-15;Culture-loisirs;54;33;19;25;27;48;206
august-15;Economie;96;104;70;42;21;50;383
august-15;Education;13;5;7;4;2;9;40
august-15;Environnement;27;37;21;8;7;23;123
august-15;Faits divers;25;22;22;15;3;30;117
august-15;Histoire-hommages;4;9;6;1;7;5;32
august-15;International;47;63;30;39;118;37;334
august-15;Justice;7;13;13;11;10;8;62
august-15;Politique France;55;52;49;28;14;45;243
august-15;Santé;9;11;4;6;2;11;43
august-15;Sciences et techniques;18;12;13;5;3;12;63
august-15;Société;93;87;68;22;23;72;365
august-15;Sport;41;39;31;39;2;29;181
september-15;Catastrophes;23;39;31;5;1;35;134
september-15;Culture-loisirs;48;33;30;11;26;54;202
september-15;Economie;65;100;39;13;11;37;265
september-15;Education;31;18;22;7;0;20;98
september-15;Environnement;42;56;33;19;19;26;195
september-15;Faits divers;12;13;19;7;3;21;75
september-15;Histoire-hommages;9;7;8;4;6;5;39
september-15;International;97;156;87;48;149;83;620
september-15;Justice;19;18;16;14;8;31;106
september-15;Politique France;59;86;59;16;21;45;286
september-15;Santé;15;9;20;4;1;17;66
september-15;Sciences et techniques;21;13;8;3;7;13;65
september-15;Société;108;119;66;27;36;94;450
september-15;Sport;85;37;26;45;2;32;227
october-15;Catastrophes;74;79;49;14;9;55;280
october-15;Culture-loisirs;44;33;22;10;27;51;187
october-15;Economie;32;61;19;9;10;17;148
october-15;Education;8;16;6;4;2;6;42
october-15;Environnement;34;19;25;5;9;19;111
october-15;Faits divers;19;26;22;6;5;30;108
october-15;Histoire-hommages;5;9;4;2;3;4;27
october-15;International;53;91;41;43;152;53;433
october-15;Justice;22;25;28;23;6;35;139
october-15;Politique France;34;35;32;10;13;23;147
october-15;Santé;17;15;14;5;2;15;68
october-15;Sciences et techniques;3;8;7;2;3;9;32
october-15;Société;94;100;73;35;23;77;402
october-15;Sport;65;22;23;35;2;16;163
november-15;Catastrophes;43;40;33;10;6;38;170
november-15;Culture-loisirs;33;22;8;6;22;40;131
november-15;Economie;34;53;33;3;3;19;145
november-15;Education;5;2;4;1;1;3;16
november-15;Environnement;52;37;32;15;7;18;161
november-15;Faits divers;12;7;7;5;1;13;45
november-15;Histoire-hommages;6;7;4;5;10;6;38
november-15;International;99;133;57;64;117;90;560
november-15;Justice;16;11;14;16;1;20;78
november-15;Politique France;169;215;149;85;49;152;819
november-15;Santé;10;8;9;5;1;16;49
november-15;Sciences et techniques;10;7;4;3;4;11;39
november-15;Société;42;39;24;20;14;46;185
november-15;Sport;17;13;10;27;4;18;89
december-15;Catastrophes;6;19;10;6;2;18;61
december-15;Culture-loisirs;75;40;29;21;30;63;258
december-15;Economie;54;60;38;10;6;35;203
december-15;Education;5;7;3;1;2;6;24
december-15;Environnement;87;84;69;25;48;52;365
december-15;Faits divers;18;22;28;7;5;24;104
december-15;Histoire-hommages;8;9;4;2;4;1;28
december-15;International;53;112;56;44;122;42;429
december-15;Justice;16;13;15;13;11;17;85
december-15;Politique France;128;125;99;54;37;145;588
december-15;Santé;19;11;21;4;3;15;73
december-15;Sciences et techniques;12;9;4;1;3;3;32
december-15;Société;95;97;62;24;21;77;376
december-15;Sport;27;14;12;35;2;25;115
january-16;Catastrophes;24;32;29;6;2;30;123
january-16;Culture-loisirs;47;41;15;11;23;42;179
january-16;Economie;53;56;32;13;7;26;187
january-16;Education;16;5;6;0;4;12;43
january-16;Environnement;40;31;29;6;6;16;128
january-16;Faits divers;15;24;23;11;20;33;126
january-16;Histoire-hommages;22;27;21;18;16;22;126
january-16;International;45;76;26;48;92;39;326
january-16;Justice;20;16;22;11;12;26;107
january-16;Politique France;79;95;68;42;24;57;365
january-16;Santé;23;24;23;7;6;18;101
january-16;Sciences et techniques;12;7;7;5;1;10;42
january-16;Société;84;102;75;22;22;97;402
january-16;Sport;27;20;15;10;0;14;86
february-16;Catastrophes;41;49;42;8;5;47;192
february-16;Culture-loisirs;43;33;21;8;31;54;190
february-16;Economie;75;86;58;10;12;47;288
february-16;Education;10;3;2;1;0;6;22
february-16;Environnement;14;20;9;0;3;9;55
february-16;Faits divers;12;14;16;3;6;27;78
february-16;Histoire-hommages;8;9;6;5;7;3;38
february-16;International;63;113;34;50;122;50;432
february-16;Justice;16;23;23;15;5;26;108
february-16;Politique France;66;68;57;41;15;46;293
february-16;Santé;20;9;8;7;4;18;66
february-16;Sciences et techniques;12;8;4;2;2;4;32
february-16;Société;83;84;70;27;22;82;368
february-16;Sport;32;15;15;21;3;29;115
march-16;Catastrophes;17;18;32;6;1;21;95
march-16;Culture-loisirs;58;49;22;9;34;49;221
march-16;Economie;65;75;60;12;4;44;260
march-16;Education;7;4;4;1;2;9;27
march-16;Environnement;18;17;15;5;10;15;80
march-16;Faits divers;14;18;17;7;2;27;85
march-16;Histoire-hommages;21;18;11;7;9;12;78
march-16;International;158;214;128;103;180;158;941
march-16;Justice;12;12;14;5;6;18;67
march-16;Politique France;53;73;50;30;8;49;263
march-16;Santé;18;12;12;7;2;23;74
march-16;Sciences et techniques;17;19;10;3;7;14;70
march-16;Société;122;135;96;50;20;108;531
march-16;Sport;45;22;18;29;0;25;139
april-16;Catastrophes;16;15;19;3;8;18;79
april-16;Culture-loisirs;47;20;18;6;29;43;163
april-16;Economie;66;64;41;13;8;30;222
april-16;Education;14;5;8;0;1;8;36
april-16;Environnement;21;16;21;3;17;15;93
april-16;Faits divers;12;11;12;9;1;29;74
april-16;Histoire-hommages;13;16;14;3;6;11;63
april-16;International;67;98;39;49;106;59;418
april-16;Justice;21;39;26;19;19;32;156
april-16;Politique France;39;48;37;17;6;32;179
april-16;Santé;20;11;9;0;4;16;60
april-16;Sciences et techniques;18;18;12;1;3;16;68
april-16;Société;105;122;100;50;34;122;533
april-16;Sport;35;26;27;31;0;28;147
may-16;Catastrophes;97;125;96;40;7;66;431
may-16;Culture-loisirs;59;49;42;15;36;64;265
may-16;Economie;42;69;27;6;18;38;200
may-16;Education;15;12;12;1;2;12;54
may-16;Environnement;19;22;14;4;8;8;75
may-16;Faits divers;18;21;23;12;4;39;117
may-16;Histoire-hommages;15;20;12;8;14;16;85
may-16;International;37;82;31;43;140;46;379
may-16;Justice;17;19;20;18;9;26;109
may-16;Politique France;42;56;34;22;14;35;203
may-16;Santé;13;10;6;1;1;21;52
may-16;Sciences et techniques;19;9;10;2;6;11;57
may-16;Société;156;196;126;43;37;136;694
may-16;Sport;62;44;28;41;4;62;241
june-16;Catastrophes;49;54;59;8;5;40;215
june-16;Culture-loisirs;23;20;15;3;17;32;110
june-16;Economie;21;28;14;2;9;15;89
june-16;Education;15;4;7;1;1;11;39
june-16;Environnement;12;18;11;2;5;10;58
june-16;Faits divers;12;13;11;4;3;14;57
june-16;Histoire-hommages;11;12;11;5;11;10;60
june-16;International;107;144;88;45;138;88;610
june-16;Justice;5;8;10;5;6;8;42
june-16;Politique France;69;81;45;30;13;47;285
june-16;Santé;6;4;3;1;0;8;22
june-16;Sciences et techniques;10;7;3;2;2;2;26
june-16;Société;64;87;58;27;27;60;323
june-16;Sport;129;55;80;43;9;214;530
july-16;Catastrophes;20;22;16;0;2;23;83
july-16;Culture-loisirs;38;27;19;0;26;26;136
july-16;Economie;34;37;22;0;7;12;112
july-16;Education;4;5;3;0;0;9;21
july-16;Environnement;17;7;2;0;3;3;32
july-16;Faits divers;12;11;10;0;4;15;52
july-16;Histoire-hommages;21;19;11;0;4;5;60
july-16;International;53;95;39;0;111;50;348
july-16;Justice;8;7;5;0;8;11;39
july-16;Politique France;162;171;120;0;33;157;643
july-16;Santé;10;3;5;0;3;2;23
july-16;Sciences et techniques;17;10;2;0;4;4;37
july-16;Société;53;44;41;0;22;48;208
july-16;Sport;131;99;85;0;9;151;475
august-16;Catastrophes;56;64;57;0;5;54;236
august-16;Culture-loisirs;60;28;23;0;35;54;200
august-16;Economie;89;73;48;0;13;36;259
august-16;Education;26;8;9;0;0;17;60
august-16;Environnement;33;25;16;0;4;11;89
august-16;Faits divers;25;21;23;0;3;36;108
august-16;Histoire-hommages;7;8;5;0;9;3;32
august-16;International;37;72;31;0;166;52;358
august-16;Justice;17;13;10;0;11;18;69
august-16;Politique France;70;83;66;0;15;55;289
august-16;Santé;11;7;7;0;4;10;39
august-16;Sciences et techniques;10;9;4;0;6;13;42
august-16;Société;96;78;49;0;26;71;320
august-16;Sport;118;166;90;0;9;60;443
september-16;Catastrophes;18;17;21;0;3;15;74
september-16;Culture-loisirs;40;34;20;0;28;45;167
september-16;Economie;75;61;48;0;17;36;237
september-16;Education;12;7;4;0;0;13;36
september-16;Environnement;18;25;20;0;3;10;76
september-16;Faits divers;12;16;14;0;2;21;65
september-16;Histoire-hommages;12;12;13;0;13;11;61
september-16;International;56;84;37;0;122;55;354
september-16;Justice;27;28;20;0;11;25;111
september-16;Politique France;76;107;74;0;14;65;336
september-16;Santé;21;10;17;0;3;17;68
september-16;Sciences et techniques;19;14;6;0;6;7;52
september-16;Société;71;57;61;0;25;75;289
september-16;Sport;34;28;21;0;2;24;109
october-16;Catastrophes;31;31;25;0;8;36;131
october-16;Culture-loisirs;40;22;23;0;23;42;150
october-16;Economie;39;62;47;0;9;32;189
october-16;Education;7;6;3;0;2;16;34
october-16;Environnement;12;17;11;0;4;11;55
october-16;Faits divers;21;32;28;0;7;35;123
october-16;Histoire-hommages;8;8;10;0;3;4;33
october-16;International;77;112;50;0;123;50;412
october-16;Justice;9;9;10;0;2;12;42
october-16;Politique France;92;92;85;0;26;62;357
october-16;Santé;13;7;11;0;2;15;48
october-16;Sciences et techniques;16;8;5;0;8;9;46
october-16;Société;58;63;46;0;27;65;259
october-16;Sport;21;11;12;0;0;15;59
november-16;Catastrophes;24;28;26;0;7;33;118
november-16;Culture-loisirs;40;17;14;0;21;54;146
november-16;Economie;34;53;43;0;9;32;171
november-16;Education;9;12;3;0;1;10;35
november-16;Environnement;17;12;22;0;12;10;73
november-16;Faits divers;12;12;21;0;1;29;75
november-16;Histoire-hommages;19;18;17;0;11;18;83
november-16;International;110;150;62;0;162;92;576
november-16;Justice;10;11;14;0;4;24;63
november-16;Politique France;179;207;153;0;23;134;696
november-16;Santé;21;8;15;0;4;18;66
november-16;Sciences et techniques;37;16;13;0;4;17;87
november-16;Société;53;62;59;0;29;76;279
november-16;Sport;33;15;18;0;1;26;93
december-16;Catastrophes;14;12;7;0;8;16;57
december-16;Culture-loisirs;54;25;25;0;27;50;181
december-16;Economie;41;51;31;0;11;28;162
december-16;Education;12;3;3;0;1;2;21
december-16;Environnement;33;30;29;0;5;23;120
december-16;Faits divers;7;5;12;0;3;21;48
december-16;Histoire-hommages;17;21;22;0;13;17;90
december-16;International;86;131;66;0;135;74;492
december-16;Justice;22;24;35;0;13;27;121
december-16;Politique France;67;58;51;0;8;51;235
december-16;Santé;16;11;10;0;2;20;59
december-16;Sciences et techniques;9;10;9;0;1;5;34
december-16;Société;90;71;58;0;26;77;322
december-16;Sport;24;20;18;0;2;18;82
january-17;Catastrophes;50;59;49;0;3;46;207
january-17;Culture-loisirs;48;33;27;0;34;55;197
january-17;Economie;44;70;40;0;9;49;212
january-17;Education;14;7;5;0;2;3;31
january-17;Environnement;42;35;27;0;6;26;136
january-17;Faits divers;10;13;20;0;4;27;74
january-17;Histoire-hommages;9;12;8;0;11;10;50
january-17;International;57;110;51;0;163;70;451
january-17;Justice;13;14;20;0;11;26;84
january-17;Politique France;174;141;114;0;26;130;585
january-17;Santé;19;18;28;0;3;21;89
january-17;Sciences et techniques;26;12;7;0;5;9;59
january-17;Société;78;80;71;0;20;83;332
january-17;Sport;50;26;31;0;1;29;137
february-17;Catastrophes;19;21;27;0;1;18;86
february-17;Culture-loisirs;51;30;25;0;27;59;192
february-17;Economie;67;56;57;0;10;32;222
february-17;Education;7;7;3;0;1;8;26
february-17;Environnement;11;10;8;0;1;2;32
february-17;Faits divers;28;39;37;0;7;38;149
february-17;Histoire-hommages;1;3;4;0;3;3;14
february-17;International;34;73;21;0;129;42;299
february-17;Justice;23;24;17;0;9;23;96
february-17;Politique France;125;144;101;0;20;81;471
february-17;Santé;9;8;9;0;1;13;40
february-17;Sciences et techniques;12;9;4;0;3;12;40
february-17;Société;71;47;39;0;18;58;233
february-17;Sport;21;21;14;0;3;17;76
march-17;Catastrophes;7;12;15;0;2;10;46
march-17;Culture-loisirs;21;19;20;0;25;41;126
march-17;Economie;43;41;23;0;12;25;144
march-17;Education;10;6;6;0;1;4;27
march-17;Environnement;12;18;16;0;7;8;61
march-17;Faits divers;26;23;26;0;2;28;105
march-17;Histoire-hommages;8;9;7;0;5;10;39
march-17;International;51;80;50;0;123;53;357
march-17;Justice;12;13;20;0;14;22;81
march-17;Politique France;138;157;86;0;17;111;509
march-17;Santé;15;5;7;0;2;17;46
march-17;Sciences et techniques;15;8;7;0;8;9;47
march-17;Société;74;80;63;0;27;67;311
march-17;Sport;25;14;11;0;0;11;61
april-17;Catastrophes;7;4;6;0;2;14;33
april-17;Culture-loisirs;21;14;15;0;20;36;106
april-17;Economie;37;31;19;0;10;21;118
april-17;Education;4;5;0;0;1;1;11
april-17;Environnement;10;16;14;0;3;3;46
april-17;Faits divers;5;6;10;0;0;12;33
april-17;Histoire-hommages;4;5;4;0;5;2;20
april-17;International;63;101;50;0;118;54;386
april-17;Justice;5;5;12;0;9;14;45
april-17;Politique France;145;210;130;0;58;156;699
april-17;Santé;8;3;7;0;1;9;28
april-17;Sciences et techniques;15;9;7;0;13;9;53
april-17;Société;49;43;47;0;20;71;230
april-17;Sport;19;13;10;0;0;13;55
may-17;Catastrophes;7;11;12;0;3;7;40
may-17;Culture-loisirs;24;27;30;0;29;55;165
may-17;Economie;55;32;40;0;7;34;168
may-17;Education;12;8;6;0;0;6;32
may-17;Environnement;19;13;18;0;13;18;81
may-17;Faits divers;8;7;14;0;5;19;53
may-17;Histoire-hommages;6;8;7;0;9;10;40
may-17;International;74;92;65;0;134;77;442
may-17;Justice;16;21;15;0;19;24;95
may-17;Politique France;234;306;177;0;55;188;960
may-17;Santé;10;6;7;0;3;21;47
may-17;Sciences et techniques;26;12;14;0;10;9;71
may-17;Société;57;54;37;0;23;73;244
may-17;Sport;36;26;22;0;0;29;113
june-17;Catastrophes;24;26;19;0;11;29;109
june-17;Culture-loisirs;30;21;17;0;17;40;125
june-17;Economie;31;37;37;0;13;31;149
june-17;Education;19;14;9;0;0;16;58
june-17;Environnement;28;16;23;0;8;22;97
june-17;Faits divers;7;5;7;0;0;1;20
june-17;Histoire-hommages;16;22;17;0;12;10;77
june-17;International;53;84;49;0;107;56;349
june-17;Justice;28;29;21;0;14;25;117
june-17;Politique France;145;158;102;0;35;104;544
june-17;Santé;11;5;8;0;4;17;45
june-17;Sciences et techniques;17;13;5;0;11;8;54
june-17;Société;36;42;24;0;21;48;171
june-17;Sport;26;29;13;0;1;17;86
july-17;Catastrophes;63;59;47;0;3;47;219
july-17;Culture-loisirs;44;13;22;0;24;46;149
july-17;Economie;68;84;39;0;13;34;238
july-17;Education;13;9;6;0;1;15;44
july-17;Environnement;29;20;19;0;15;19;102
july-17;Faits divers;2;3;1;0;1;7;14
july-17;Histoire-hommages;16;18;12;0;11;15;72
july-17;International;34;51;33;0;121;49;288
july-17;Justice;13;17;14;0;8;19;71
july-17;Politique France;87;87;61;0;13;63;311
july-17;Santé;10;1;11;0;8;10;40
july-17;Sciences et techniques;14;4;5;0;8;4;35
july-17;Société;64;71;48;0;17;84;284
july-17;Sport;33;44;40;0;2;39;158
august-17;Catastrophes;50;48;68;0;17;58;241
august-17;Culture-loisirs;56;41;24;0;34;46;201
august-17;Economie;78;89;42;0;16;37;262
august-17;Education;28;12;11;0;0;9;60
august-17;Environnement;46;24;15;0;14;9;108
august-17;Faits divers;14;21;23;0;3;29;90
august-17;Histoire-hommages;15;13;21;0;13;9;71
august-17;International;74;116;76;0;173;65;504
august-17;Justice;6;8;8;0;13;18;53
august-17;Politique France;69;71;58;0;7;49;254
august-17;Santé;31;26;20;0;9;25;111
august-17;Sciences et techniques;12;9;8;0;9;19;57
august-17;Société;101;94;65;0;28;89;377
august-17;Sport;45;42;43;0;4;38;172
september-17;Catastrophes;103;92;95;16;20;104;430
september-17;Culture-loisirs;29;19;22;2;21;47;140
september-17;Economie;58;68;55;13;7;32;233
september-17;Education;23;10;8;2;3;14;60
september-17;Environnement;19;17;21;3;9;10;79
september-17;Faits divers;13;9;18;5;0;20;65
september-17;Histoire-hommages;6;7;6;2;6;3;30
september-17;International;45;73;36;25;146;47;372
september-17;Justice;10;9;7;3;7;8;44
september-17;Politique France;33;43;28;16;7;29;156
september-17;Santé;20;7;12;1;4;10;54
september-17;Sciences et techniques;11;7;4;2;4;9;37
september-17;Société;80;93;61;21;26;80;361
september-17;Sport;40;28;15;9;0;27;119
october-17;Catastrophes;25;33;28;5;8;35;134
october-17;Culture-loisirs;43;25;24;6;28;68;194
october-17;Economie;72;82;55;17;7;42;275
october-17;Education;20;14;6;2;1;10;53
october-17;Environnement;16;25;16;6;5;17;85
october-17;Faits divers;32;33;41;13;10;45;174
october-17;Histoire-hommages;9;10;8;6;5;8;46
october-17;International;85;126;69;27;168;74;549
october-17;Justice;21;24;34;14;10;29;132
october-17;Politique France;55;79;68;15;12;54;283
october-17;Santé;19;25;20;3;8;24;99
october-17;Sciences et techniques;18;9;5;5;17;13;67
october-17;Société;98;111;71;23;40;98;441
october-17;Sport;31;15;9;5;0;21;81
november-17;Catastrophes;13;16;21;9;4;16;79
november-17;Culture-loisirs;36;16;12;8;22;46;140
november-17;Economie;57;80;47;10;8;32;234
november-17;Education;16;5;10;4;4;11;50
november-17;Environnement;27;19;14;6;23;15;104
november-17;Faits divers;21;20;26;4;4;38;113
november-17;Histoire-hommages;9;10;7;3;7;2;38
november-17;International;52;64;29;32;94;44;315
november-17;Justice;19;29;21;8;15;25;117
november-17;Politique France;40;62;41;14;5;30;192
november-17;Santé;22;20;20;7;8;25;102
november-17;Sciences et techniques;14;5;9;1;7;8;44
november-17;Société;85;90;67;19;30;96;387
november-17;Sport;31;22;26;5;1;26;111
december-17;Catastrophes;60;53;60;8;4;34;219
december-17;Culture-loisirs;32;16;20;2;18;43;131
december-17;Economie;63;69;30;6;14;23;205
december-17;Education;12;5;4;2;0;6;29
december-17;Environnement;17;28;8;6;9;5;73
december-17;Faits divers;16;12;28;5;2;20;83
december-17;Histoire-hommages;66;55;47;5;5;46;224
december-17;International;34;90;31;25;138;41;359
december-17;Justice;5;7;14;2;6;10;44
december-17;Politique France;34;55;37;12;11;44;193
december-17;Santé;17;17;20;0;3;16;73
december-17;Sciences et techniques;7;6;3;5;12;10;43
december-17;Société;87;82;67;11;28;77;352
december-17;Sport;24;15;12;5;1;27;84
january-18;Catastrophes;103;107;115;8;2;59;394
january-18;Culture-loisirs;45;31;26;7;25;60;194
january-18;Economie;59;75;38;14;11;28;225
january-18;Education;16;11;4;2;4;11;48
january-18;Environnement;42;47;18;9;12;22;150
january-18;Faits divers;18;23;22;4;4;30;101
january-18;Histoire-hommages;17;22;12;2;11;17;81
january-18;International;38;66;33;20;140;53;350
january-18;Justice;20;30;22;5;8;26;111
january-18;Politique France;74;82;68;13;17;43;297
january-18;Santé;31;22;23;6;13;36;131
january-18;Sciences et techniques;19;7;5;3;13;12;59
january-18;Société;98;83;65;23;34;86;389
january-18;Sport;31;14;15;4;1;31;96
february-18;Catastrophes;99;55;55;10;2;53;274
february-18;Culture-loisirs;20;21;23;9;21;47;141
february-18;Economie;65;60;38;7;11;40;221
february-18;Education;14;8;2;1;1;10;36
february-18;Environnement;34;30;31;6;7;29;137
february-18;Faits divers;30;25;31;5;8;32;131
february-18;Histoire-hommages;3;4;2;0;9;2;20
february-18;International;32;70;25;18;120;34;299
february-18;Justice;31;33;30;14;10;36;154
february-18;Politique France;40;66;45;18;12;49;230
february-18;Santé;17;9;10;0;3;14;53
february-18;Sciences et techniques;14;3;2;6;10;11;46
february-18;Société;73;67;44;18;19;58;279
february-18;Sport;39;48;26;16;2;40;171
march-18;Catastrophes;20;12;19;3;1;16;71
march-18;Culture-loisirs;25;25;20;5;26;54;155
march-18;Economie;39;45;30;6;9;22;151
march-18;Education;12;9;9;5;0;12;47
march-18;Environnement;25;20;21;4;9;5;84
march-18;Faits divers;21;18;17;8;7;28;99
march-18;Histoire-hommages;9;5;4;3;4;10;35
march-18;International;62;98;51;23;134;61;429
march-18;Justice;37;27;34;6;6;38;148
march-18;Politique France;73;75;58;13;13;58;290
march-18;Santé;13;18;8;2;2;17;60
march-18;Sciences et techniques;20;10;3;4;11;12;60
march-18;Société;93;113;85;25;26;96;438
march-18;Sport;23;17;13;7;0;28;88
april-18;Catastrophes;14;14;14;2;1;12;57
april-18;Culture-loisirs;17;18;18;4;25;38;120
april-18;Economie;47;33;27;5;7;29;148
april-18;Education;23;17;11;4;6;18;79
april-18;Environnement;22;19;11;1;7;10;70
april-18;Faits divers;21;12;20;5;6;26;90
april-18;Histoire-hommages;10;9;12;5;7;11;54
april-18;International;51;77;34;18;105;62;347
april-18;Justice;16;20;11;7;11;17;82
april-18;Politique France;47;55;56;14;15;38;225
april-18;Santé;15;15;10;1;4;14;59
april-18;Sciences et techniques;15;2;3;8;12;13;53
april-18;Société;154;177;140;28;40;127;666
april-18;Sport;14;21;7;5;0;19;66
may-18;Catastrophes;33;32;25;4;4;27;125
may-18;Culture-loisirs;25;34;31;13;35;57;195
may-18;Economie;62;69;38;4;10;32;215
may-18;Education;23;18;8;6;4;10;69
may-18;Environnement;28;17;20;2;13;15;95
may-18;Faits divers;29;30;38;7;4;34;142
may-18;Histoire-hommages;10;20;14;3;7;13;67
may-18;International;70;95;41;36;156;54;452
may-18;Justice;9;23;14;6;6;22;80
may-18;Politique France;49;54;55;10;15;32;215
may-18;Santé;16;17;10;7;12;23;85
may-18;Sciences et techniques;17;4;2;3;8;13;47
may-18;Société;170;169;112;28;39;142;660
may-18;Sport;37;30;15;6;0;70;158
june-18;Catastrophes;35;39;53;5;5;24;161
june-18;Culture-loisirs;17;20;15;4;20;49;125
june-18;Economie;41;61;32;11;8;29;182
june-18;Education;12;9;8;3;3;16;51
june-18;Environnement;17;38;18;4;7;12;96
june-18;Faits divers;15;15;24;7;4;36;101
june-18;Histoire-hommages;6;10;6;3;4;1;30
june-18;International;65;97;53;17;137;49;418
june-18;Justice;14;17;16;3;8;16;74
june-18;Politique France;24;41;29;6;8;20;128
june-18;Santé;12;9;9;1;6;15;52
june-18;Sciences et techniques;10;7;5;4;6;7;39
june-18;Société;72;87;64;12;26;75;336
june-18;Sport;117;53;45;14;4;61;294
july-18;Catastrophes;53;40;46;0;10;60;209
july-18;Culture-loisirs;28;20;23;0;32;52;155
july-18;Economie;66;76;35;0;7;23;207
july-18;Education;10;4;3;0;0;6;23
july-18;Environnement;43;40;33;0;19;26;161
july-18;Faits divers;36;38;38;0;5;27;144
july-18;Histoire-hommages;4;10;4;0;4;4;26
july-18;International;17;57;13;0;137;33;257
july-18;Justice;46;69;57;0;24;48;244
july-18;Politique France;17;37;28;0;8;17;107
july-18;Santé;15;13;10;0;7;9;54
july-18;Sciences et techniques;9;10;4;0;15;7;45
july-18;Société;97;80;60;0;33;83;353
july-18;Sport;168;134;121;0;6;109;538
august-18;Catastrophes;75;75;60;0;19;58;287
august-18;Culture-loisirs;35;29;26;0;24;48;162
august-18;Economie;80;81;42;0;18;33;254
august-18;Education;18;3;3;0;0;8;32
august-18;Environnement;50;28;30;0;5;24;137
august-18;Faits divers;22;23;34;0;4;32;115
august-18;Histoire-hommages;13;18;18;0;10;17;76
august-18;International;22;48;29;0;99;28;226
august-18;Justice;10;12;9;0;7;13;51
august-18;Politique France;22;37;33;0;2;34;128
august-18;Santé;23;13;10;0;3;11;60
august-18;Sciences et techniques;13;7;9;0;12;14;55
august-18;Société;94;81;47;0;40;72;334
august-18;Sport;10;18;21;0;1;25;75
september-18;Catastrophes;28;32;39;0;7;30;136
september-18;Culture-loisirs;28;22;25;0;20;55;150
september-18;Economie;78;72;45;0;15;36;246
september-18;Education;21;19;6;0;2;18;66
september-18;Environnement;29;28;23;0;14;15;109
september-18;Faits divers;12;16;32;0;2;27;89
september-18;Histoire-hommages;6;15;13;0;5;9;48
september-18;International;33;71;33;0;112;34;283
september-18;Justice;20;20;19;0;8;35;102
september-18;Politique France;32;38;41;0;9;27;147
september-18;Santé;17;15;20;0;7;14;73
september-18;Sciences et techniques;14;5;2;0;3;8;32
september-18;Société;88;95;60;0;38;72;353
september-18;Sport;13;15;12;0;3;30;73
october-18;Catastrophes;98;98;92;0;7;67;362
october-18;Culture-loisirs;39;27;17;0;26;59;168
october-18;Economie;85;67;41;0;8;38;239
october-18;Education;8;10;7;0;4;11;40
october-18;Environnement;36;40;32;0;17;16;141
october-18;Faits divers;22;28;25;0;6;36;117
october-18;Histoire-hommages;32;27;25;0;10;21;115
october-18;International;46;84;38;0;150;52;370
october-18;Justice;21;21;28;0;6;26;102
october-18;Politique France;32;38;44;0;7;30;151
october-18;Santé;19;20;21;0;11;30;101
october-18;Sciences et techniques;14;5;5;0;9;8;41
october-18;Société;98;96;69;0;38;80;381
october-18;Sport;9;11;8;0;0;25;53
november-18;Catastrophes;22;20;19;0;8;24;93
november-18;Culture-loisirs;23;23;16;0;21;42;125
november-18;Economie;80;93;47;0;12;55;287
november-18;Education;7;5;5;0;1;8;26
november-18;Environnement;15;14;10;0;8;11;58
november-18;Faits divers;20;15;24;0;2;27;88
november-18;Histoire-hommages;24;29;35;0;17;26;131
november-18;International;26;43;13;0;111;21;214
november-18;Justice;13;19;19;0;15;23;89
november-18;Politique France;30;40;35;0;6;32;143
november-18;Santé;8;9;9;0;4;10;40
november-18;Sciences et techniques;5;4;0;0;16;9;34
november-18;Société;143;128;135;0;23;92;521
november-18;Sport;9;14;10;0;1;33;67
december-18;Catastrophes;16;13;15;0;5;15;64
december-18;Culture-loisirs;19;17;13;0;18;35;102
december-18;Economie;129;114;79;0;16;67;405
december-18;Education;10;8;10;0;6;14;48
december-18;Environnement;13;21;11;0;24;10;79
december-18;Faits divers;5;7;3;0;1;15;31
december-18;Histoire-hommages;3;6;8;0;2;8;27
december-18;International;20;44;14;0;99;23;200
december-18;Justice;5;14;13;0;6;21;59
december-18;Politique France;93;125;85;0;16;75;394
december-18;Santé;4;6;7;0;2;9;28
december-18;Sciences et techniques;3;5;3;0;5;3;19
december-18;Société;136;108;109;0;36;127;516
december-18;Sport;6;4;3;0;1;10;24
january-19;Catastrophes;36;43;39;0;5;30;153
january-19;Culture-loisirs;25;30;29;0;26;58;168
january-19;Economie;100;90;54;0;9;39;292
january-19;Education;7;8;3;0;2;8;28
january-19;Environnement;19;18;18;0;11;25;91
january-19;Faits divers;28;33;37;0;6;35;139
january-19;Histoire-hommages;9;14;18;0;15;7;63
january-19;International;30;58;20;0;142;46;296
january-19;Justice;14;31;34;0;10;34;123
january-19;Politique France;88;102;105;0;16;64;375
january-19;Santé;21;16;13;0;3;21;74
january-19;Sciences et techniques;17;5;6;0;15;17;60
january-19;Société;116;128;77;0;33;91;445
january-19;Sport;8;12;13;0;0;17;50
february-19;Catastrophes;28;17;25;0;0;22;92
february-19;Culture-loisirs;18;28;20;0;29;47;142
february-19;Economie;85;69;54;0;14;51;273
february-19;Education;9;5;1;0;1;7;23
february-19;Environnement;27;20;25;0;9;19;100
february-19;Faits divers;27;19;25;0;2;38;111
february-19;Histoire-hommages;6;11;4;0;7;4;32
february-19;International;30;64;22;0;115;51;282
february-19;Justice;12;20;27;0;8;29;96
february-19;Politique France;40;42;50;0;7;31;170
february-19;Santé;21;16;10;0;3;17;67
february-19;Sciences et techniques;12;5;4;0;12;6;39
february-19;Société;93;132;80;0;30;90;425
february-19;Sport;7;11;8;0;0;20;46
march-19;Catastrophes;18;30;26;0;5;19;98
march-19;Culture-loisirs;24;19;24;0;22;48;137
march-19;Economie;53;55;36;0;10;20;174
march-19;Education;11;2;3;0;2;6;24
march-19;Environnement;27;28;28;0;13;24;120
march-19;Faits divers;15;12;22;0;1;29;79
march-19;Histoire-hommages;3;7;2;0;5;3;20
march-19;International;42;93;48;0;116;55;354
march-19;Justice;16;24;18;0;15;28;101
march-19;Politique France;60;51;71;0;10;45;237
march-19;Santé;24;16;17;0;6;20;83
march-19;Sciences et techniques;14;6;3;0;7;8;38
march-19;Société;94;106;62;0;21;76;359
march-19;Sport;7;14;5;0;0;30;56
april-19;Catastrophes;9;7;13;0;2;14;45
april-19;Culture-loisirs;51;47;29;0;26;69;222
april-19;Economie;84;76;62;0;5;36;263
april-19;Education;15;16;5;0;1;13;50
april-19;Environnement;20;30;19;0;11;17;97
april-19;Faits divers;90;111;46;0;8;88;343
april-19;Histoire-hommages;12;11;14;0;12;15;64
april-19;International;38;77;51;0;169;73;408
april-19;Justice;13;21;29;0;9;33;105
april-19;Politique France;58;68;46;0;10;45;227
april-19;Santé;17;15;18;0;10;20;80
april-19;Sciences et techniques;17;12;4;0;13;10;56
april-19;Société;135;108;95;0;33;106;477
april-19;Sport;10;16;12;0;1;21;60
may-19;Catastrophes;12;9;10;0;1;9;41
may-19;Culture-loisirs;22;21;33;0;25;54;155
may-19;Economie;88;73;48;0;13;28;250
may-19;Education;9;5;4;0;3;5;26
may-19;Environnement;21;19;23;0;13;15;91
may-19;Faits divers;16;20;25;0;1;25;87
may-19;Histoire-hommages;6;7;10;0;11;3;37
may-19;International;78;82;71;0;156;104;491
may-19;Justice;21;22;28;0;9;31;111
may-19;Politique France;33;40;39;0;6;36;154
may-19;Santé;11;15;10;0;2;13;51
may-19;Sciences et techniques;19;7;9;0;3;10;48
may-19;Société;70;80;54;0;21;72;297
may-19;Sport;9;11;6;0;0;30;56
june-19;Catastrophes;50;57;27;0;1;41;176
june-19;Culture-loisirs;19;22;21;0;23;39;124
june-19;Economie;50;55;40;0;18;34;197
june-19;Education;15;16;4;0;3;12;50
june-19;Environnement;56;52;32;0;19;27;186
june-19;Faits divers;23;21;28;0;8;33;113
june-19;Histoire-hommages;26;18;24;0;10;24;102
june-19;International;18;40;17;0;114;38;227
june-19;Justice;14;21;19;0;10;20;84
june-19;Politique France;33;28;30;0;5;21;117
june-19;Santé;25;19;21;0;13;31;109
june-19;Sciences et techniques;10;11;3;0;10;6;40
june-19;Société;77;84;64;0;19;59;303
june-19;Sport;52;23;22;0;3;31;131
july-19;Catastrophes;61;54;52;0;3;58;228
july-19;Culture-loisirs;25;26;27;0;34;50;162
july-19;Economie;97;81;49;0;12;30;269
july-19;Education;19;11;14;0;1;18;63
july-19;Environnement;85;66;51;0;22;48;272
july-19;Faits divers;21;18;27;0;0;32;98
july-19;Histoire-hommages;5;4;3;0;7;5;24
july-19;International;22;59;29;0;151;39;300
july-19;Justice;13;17;14;0;10;27;81
july-19;Politique France;43;64;56;0;9;44;216
july-19;Santé;25;15;14;0;7;19;80
july-19;Sciences et techniques;28;19;6;0;12;17;82
july-19;Société;101;94;79;0;33;74;381
july-19;Sport;23;39;45;0;5;35;147
august-19;Catastrophes;57;55;47;0;13;54;226
august-19;Culture-loisirs;21;19;22;0;22;39;123
august-19;Economie;65;63;44;0;6;18;196
august-19;Education;13;6;6;0;0;11;36
august-19;Environnement;52;35;29;0;19;22;157
august-19;Faits divers;34;30;36;0;2;42;144
august-19;Histoire-hommages;8;13;19;0;8;12;60
august-19;International;32;84;57;0;141;59;373
august-19;Justice;7;11;16;0;13;19;66
august-19;Politique France;21;37;29;0;3;27;117
august-19;Santé;14;16;6;0;4;13;53
august-19;Sciences et techniques;18;13;6;0;6;9;52
august-19;Société;89;76;49;0;14;73;301
august-19;Sport;5;12;10;0;1;16;44
september-19;Catastrophes;46;40;38;0;10;34;168
september-19;Culture-loisirs;25;17;24;0;19;39;124
september-19;Economie;64;74;37;0;5;33;213
september-19;Education;9;9;8;0;2;14;42
september-19;Environnement;34;41;32;0;20;23;150
september-19;Faits divers;21;19;20;0;3;26;89
september-19;Histoire-hommages;28;38;28;0;10;31;135
september-19;International;20;39;22;0;125;31;237
september-19;Justice;15;16;23;0;7;27;88
september-19;Politique France;25;39;33;0;6;29;132
september-19;Santé;13;23;13;0;4;14;67
september-19;Sciences et techniques;13;6;4;0;12;8;43
september-19;Société;91;95;76;0;20;80;362
september-19;Sport;20;17;7;0;0;29;73
october-19;Catastrophes;85;72;76;0;11;57;301
october-19;Culture-loisirs;26;27;25;0;21;65;164
october-19;Economie;57;76;36;0;15;46;230
october-19;Education;5;3;4;0;0;8;20
october-19;Environnement;25;33;20;0;15;16;109
october-19;Faits divers;24;28;30;0;5;35;122
october-19;Histoire-hommages;27;18;20;0;11;21;97
october-19;International;61;97;52;0;181;78;469
october-19;Justice;19;20;19;0;9;28;95
october-19;Politique France;42;49;53;0;8;34;186
october-19;Santé;19;11;13;0;5;16;64
october-19;Sciences et techniques;16;8;5;0;12;7;48
october-19;Société;99;104;76;0;28;74;381
october-19;Sport;17;12;11;0;1;34;75
november-19;Catastrophes;71;62;67;0;5;43;248
november-19;Culture-loisirs;18;14;15;0;21;42;110
november-19;Economie;64;47;29;0;14;37;191
november-19;Education;4;10;3;0;0;7;24
november-19;Environnement;27;31;14;0;8;16;96
november-19;Faits divers;16;14;24;0;7;28;89
november-19;Histoire-hommages;8;16;14;0;12;8;58
november-19;International;31;50;33;0;110;44;268
november-19;Justice;12;17;9;0;6;29;73
november-19;Politique France;17;39;41;0;8;17;122
november-19;Santé;13;18;12;0;6;8;57
november-19;Sciences et techniques;9;10;0;0;5;6;30
november-19;Société;96;99;83;0;35;85;398
november-19;Sport;7;9;8;0;3;31;58
december-19;Catastrophes;45;41;49;0;11;53;199
december-19;Culture-loisirs;17;16;16;0;17;43;109
december-19;Economie;46;45;25;0;15;32;163
december-19;Education;7;7;3;0;1;5;23
december-19;Environnement;27;22;20;0;15;17;101
december-19;Faits divers;8;8;11;0;6;19;52
december-19;Histoire-hommages;7;12;4;0;5;4;32
december-19;International;16;38;23;0;111;36;224
december-19;Justice;9;12;13;0;4;16;54
december-19;Politique France;10;18;16;0;4;19;67
december-19;Santé;4;3;9;0;5;5;26
december-19;Sciences et techniques;10;3;7;0;10;7;37
december-19;Société;221;236;166;0;38;177;838
december-19;Sport;2;2;7;0;1;10;22
january-20;Catastrophes;46;43;30;0;16;36;171
january-20;Culture-loisirs;15;22;14;0;16;39;106
january-20;Economie;60;53;36;0;7;33;189
january-20;Education;5;6;3;0;0;6;20
january-20;Environnement;18;20;7;0;14;11;70
january-20;Faits divers;19;14;19;0;2;24;78
january-20;Histoire-hommages;10;9;10;0;9;11;49
january-20;International;23;40;21;0;120;36;240
january-20;Justice;9;20;21;0;8;21;79
january-20;Politique France;23;35;34;0;4;18;114
january-20;Santé;47;57;44;0;19;37;204
january-20;Sciences et techniques;13;8;4;0;7;10;42
january-20;Société;128;149;102;0;27;117;523
january-20;Sport;4;7;9;0;1;11;32
february-20;Catastrophes;19;24;30;0;2;25;100
february-20;Culture-loisirs;13;20;18;0;21;46;118
february-20;Economie;66;60;38;0;8;47;219
february-20;Education;3;6;1;0;0;2;12
february-20;Environnement;39;27;19;0;11;21;117
february-20;Faits divers;13;8;6;0;2;24;53
february-20;Histoire-hommages;10;8;8;0;7;11;44
february-20;International;21;37;13;0;107;20;198
february-20;Justice;10;17;12;0;9;20;68
february-20;Politique France;29;43;44;0;9;29;154
february-20;Santé;98;123;108;0;23;104;456
february-20;Sciences et techniques;15;11;16;0;6;9;57
february-20;Société;73;73;36;0;24;49;255
february-20;Sport;14;25;17;0;2;24;82
march-20;Catastrophes;9;10;3;0;2;7;31
march-20;Culture-loisirs;6;6;8;0;15;21;56
march-20;Economie;44;57;24;0;15;32;172
march-20;Education;2;4;1;0;1;3;11
march-20;Environnement;7;7;6;0;4;8;32
march-20;Faits divers;0;5;0;0;2;7;14
march-20;Histoire-hommages;3;5;4;0;7;7;26
march-20;International;9;14;5;0;62;14;104
march-20;Justice;5;7;11;0;7;9;39
march-20;Politique France;15;19;23;0;8;14;79
march-20;Santé;569;511;373;0;107;464;2024
march-20;Sciences et techniques;4;5;0;0;4;3;16
march-20;Société;24;26;17;0;14;23;104
march-20;Sport;3;3;2;0;1;10;19
april-20;Catastrophes;0;3;3;0;2;6;14
april-20;Culture-loisirs;3;6;5;0;3;8;25
april-20;Economie;97;98;55;0;29;38;317
april-20;Education;35;26;16;0;2;16;95
april-20;Environnement;0;3;3;0;2;0;8
april-20;Faits divers;4;2;1;0;1;3;11
april-20;Histoire-hommages;4;3;3;0;3;1;14
april-20;International;0;4;0;0;19;5;28
april-20;Justice;2;1;1;0;1;1;6
april-20;Politique France;4;9;3;0;1;6;23
april-20;Santé;557;475;256;0;127;361;1776
april-20;Sciences et techniques;0;0;1;0;0;2;3
april-20;Société;26;30;21;0;6;19;102
april-20;Sport;0;0;1;0;0;0;1
may-20;Catastrophes;11;5;4;0;2;12;34
may-20;Culture-loisirs;24;20;19;0;12;36;111
may-20;Economie;124;119;65;0;24;78;410
may-20;Education;43;20;11;0;3;29;106
may-20;Environnement;9;10;5;0;1;5;30
may-20;Faits divers;3;3;2;0;0;4;12
may-20;Histoire-hommages;9;10;13;0;10;9;51
may-20;International;5;15;2;0;35;5;62
may-20;Justice;2;5;5;0;8;4;24
may-20;Politique France;15;14;13;0;5;15;62
may-20;Santé;395;372;188;0;101;281;1337
may-20;Sciences et techniques;9;4;2;0;1;5;21
may-20;Société;56;47;30;0;13;32;178
may-20;Sport;3;4;2;0;0;3;12
june-20;Catastrophes;21;15;18;0;1;9;64
june-20;Culture-loisirs;26;31;29;0;19;63;168
june-20;Economie;172;128;79;0;31;57;467
june-20;Education;22;19;9;0;2;14;66
june-20;Environnement;36;28;15;0;8;24;111
june-20;Faits divers;21;23;19;0;3;26;92
june-20;Histoire-hommages;8;6;9;0;8;13;44
june-20;International;12;26;6;0;75;16;135
june-20;Justice;16;20;21;0;11;28;96
june-20;Politique France;76;84;68;0;8;105;341
june-20;Santé;162;161;90;0;59;127;599
june-20;Sciences et techniques;15;16;8;0;7;11;57
june-20;Société;114;90;63;0;53;98;418
june-20;Sport;3;3;2;0;0;10;18
july-20;Catastrophes;13;12;9;0;3;20;57
july-20;Culture-loisirs;26;36;23;0;19;41;145
july-20;Economie;83;77;64;0;24;29;277
july-20;Education;5;4;0;0;1;5;15
july-20;Environnement;33;26;21;0;6;11;97
july-20;Faits divers;32;22;29;0;4;45;132
july-20;Histoire-hommages;6;8;7;0;6;7;34
july-20;International;3;21;4;0;72;17;117
july-20;Justice;5;8;4;0;11;13;41
july-20;Politique France;59;59;46;0;9;32;205
july-20;Santé;160;127;72;0;36;87;482
july-20;Sciences et techniques;6;9;4;0;7;12;38
july-20;Société;89;42;44;0;24;48;247
july-20;Sport;5;9;6;0;0;24;44
august-20;Catastrophes;63;78;58;0;21;59;279
august-20;Culture-loisirs;24;28;21;0;16;44;133
august-20;Economie;63;54;36;0;14;27;194
august-20;Education;11;11;8;0;3;12;45
august-20;Environnement;59;37;33;0;16;24;169
august-20;Faits divers;12;10;13;0;1;14;50
august-20;Histoire-hommages;2;4;0;0;7;4;17
august-20;International;26;58;32;0;93;36;245
august-20;Justice;6;7;8;0;4;5;30
august-20;Politique France;12;19;11;0;3;5;50
august-20;Santé;190;95;78;0;18;87;468
august-20;Sciences et techniques;11;5;2;0;8;9;35
august-20;Société;53;60;36;0;24;50;223
august-20;Sport;23;30;29;0;1;26;109
september-20;Catastrophes;47;34;40;0;7;45;173
september-20;Culture-loisirs;21;24;22;0;25;49;141
september-20;Economie;86;99;58;0;7;43;293
september-20;Education;36;25;20;0;0;23;104
september-20;Environnement;36;35;14;0;14;13;112
september-20;Faits divers;28;13;15;0;4;27;87
september-20;Histoire-hommages;14;21;13;0;4;11;63
september-20;International;30;47;17;0;128;42;264
september-20;Justice;12;28;15;0;11;22;88
september-20;Politique France;33;39;42;0;11;35;160
september-20;Santé;230;162;121;0;38;113;664
september-20;Sciences et techniques;8;4;6;0;8;8;34
september-20;Société;73;56;38;0;26;57;250
september-20;Sport;13;24;33;0;1;30;101
